outbreak	guerra epidemia scoppiata pandemia scoppio conflitto scoppiato morbillo #guerra 
legendary	leggendario leggendaria leggendari semileggendario mitico leggenda semileggendari semileggendaria leggendarie 
handball	calcio pallamano pallanuoto pallavolo pallamaglio tennistavolo pallacanestro footvolley badminton 
georgian	georgiano georgiana georgiani georgianna armena georgiane georgian giorgiano russa 
copenhagen	copenaghen stoccolma copenhagen copenhaghen göteborg copen helsinki—stoccolma malmö oslo 
trek	trek stargate stellari battlestar star trekkie starcraft startrek starcrash 
ignored	ignorato ignorati ignorata ignorate attenuto avvertito disapprovato trascurato informato 
arch	arch portale colosseo arcate ingresso obelisk obelisco arcati xll 
keys	chiavi chiave key tasti keys tastiera cifrante cifranti sottochiavi 
enjoy	godere goder godersi goderti relax goderci gioia, divertimento gustare 
quartet	quartetto quartet quartett quartetti quartette trio quintetto quartettone violini 
propaganda	propaganda propagandist propagandismo propagandisti propagandiste propagandista propagandistico propaganda» propagandato 
disk	disk floppy disco filesystem zeroshell megabyte chiavetta testina dischetti 
realized	immaginato pensato rivelati rivelato intuiti sognati creduto sognato aspettati 
neat	pulito neat piacevole complessanti linear semplice complicato spacewar complessante 
funny	divertente divertenti divertenti» divertente» funny sciocco umoristico stupido umorismo 
punishment	pena fustigazione punizione condanna punizioni tortura ingiustizia pene disobbedienza 
accuracy	accuratezza precisione accuratezze inaccuratezza precisioni affidabilità imprecisione accurato accurati 
meter	metri metro velocimetro misura misurante ostacoli decimetro iarde kilometro 
theoretical	teorica teori teorici teorico teoria teoriche quantistica cosmologia teorie 
suspension	sospensione risospensione sospensiva sospensive sospensioneant sospensioni sospensivo sospensivi sospensore 
graduation	diploma diplomandi diplomano diplome diplomarsi diplomato bachelor laurea diplomando 
flew	volato volò volo pilotato decollato decollati volava decollò aereo 
seeds	frutti seme fruttini germogliati germoglio germogliate baccelli chicchi germoglia 
lighting	illuminazione luci illuminazioni aeroilluminazione lumin illuminotecnici retroilluminazione controilluminazione illuminotecnico 
jennifer	jennifer laura francesca michelle annalisa melissa tessa nicole natalie 
smooth	liscio liscia 하는 lisci compatto ruvido lisce smooth compatta 
customer	cliente clienti clientela consumatore customer cliente/consumatore acquirente fornitore aziendali 
armstrong	armstrong armstrongi wright hughes mitchell armstrongs wiggin mck evans 
southwestern	occidentale settentrionale meridionale meridional sudoccidentale orientale sudoccidentali nordoccidentale centrosettentrionale 
involve	coinvolgono coinvolga coinvolgo coinvolgano coinvolge coinvolgenti implicate implicano coinvolte 
philosophical	filosofici filosofico filosofica filosofiche filosofi» filosofia filosofici» filosofia, filosofica» 
escaped	catturato fuggiti fuggito scappati sfuggiti imprigionato liberato catturati evasi 
powell	smith robinson powell clark evans watson shaw hawes johnson 
kills	uccide uccidono uccider uccido uccidendo abbatte uccidi uccidre ucciso 
taste	gusto sapori sapore gusti drink gustar assaggio profumo culinare 
allmusic	allmusic recensione ondarock recensio recensiva allmusicitalia disco album discografia 
bros	bros warner wario dreamworks mgm walt disney barbera dreamworld 
assertion	affermazione asserzione affermazioni argomentazione asserzioni supposizione inconfutabile dimostrazione supposta 
boulevard	boulevard bulevard viale avenue boulevards boulevardier viali blvd bulevardul 
northeastern	meridional settentrionale sudoccidentale nordorientale sudorientale meridionale occidentale nordoriente nordoccidentale 
brooks	brooks mck brooksmith bowder johnson porter brown shaw bennett 
sending	inviando invio invia inviare inviar spedendo spedire mandare inviatole 
atomic	atomica atomico atomici atomiche nucleare atomics atomica» atomic atomicità 
antarctica	antartide antartic antartica antartici antartico antartiche artide subantartico subantartica 
strikes	strike colpisci #bombardamento sferra bomb シュート attacco bombardamento violentissimo 
reconstruction	ricostruzione restauro ristrutturazione ricostruzioni costruzione rifacimento ricostruzione» consolidamento risanamento 
chronicle	chronicle cronaca cronaca» cronache cronista chronicler chronicled cronacaqui cronache» 
traveling	viaggia viagg viaggiando viaggiar viaggiato viaggio viaggiare viaggiari viaggi 
leslie	leslie oliver alan malcolm russel edmund gordon russell edward 
ellis	ellis piercy brooksmith pierce jones burrell horwill tullock currell 
devon	devon sussex yorkshire flintshire wilkshire warwickshire cornovaglia northburgh lothbury 
ghana	ghana nigeria —africa gabon camerun gambia africa mafrica senegal 
gen	generale comandato comand generale, fretter colonnello comando brigadier generali 
rebel	ribelli ribelle ribellione ribellion ribello ribella sandila insurrezione guerriglieri 
duncan	duncan malcolm campbell cameron murray graham stewart fergus george 
pianist	pianista compositore sinfonista violoncellista trombettista violinista musicista saxofonista fortepianista 
canon	canon canonico winchester canonic canoniche ґ canone canonice canonis 
reformed	riformata riformato riformati riformatasi riformate riformatosi riformare riformava riformando 
pack	pack dlc backpack sixpack pokétch sexpack wildfire snowmobile minigame 
iceland	islanda norvegia frislanda scandinavia groenlandia danimarca svezia norvegian belinlandia 
solve	risolvere risolver #risolvere risolvo risolvi risolvendo risolvera risolve risolverli 
cyclists	ciclisti cicliste corridori scorridori ciclismo ciclistici automobilisti atleti motociclisti 
payment	pagamento pagamenti paga rimborso transazione ripagamento pagar tariffa pagare 
suburbs	sobborghi sobborgo quartieri quartiere periferie periferia città metropoli suburbs 
militia	milizia miliz milizie miliziani miliziano miliziotti brigata militia miliziana 
pronounced	pronunciato pronunciata pronuncia pronunciati pronunciate pronunciano pronunciatosi pronunciabile pronunce 
exhibit	mostra esposizione esposizioni espone esposi esposte esposti #esposizione permanente 
mph	km/h velocità mi/h mph km/ora m/h mach velocio orarie 
glen	glen glenna glenny glena glenne teith glenmore glenmor fergus 
eugene	eugene carlo rudy nicola jaquino leo valentina eugenij henry 
compromise	compromesso accordo soluzione concordare proposta concordate compromessi risoluzioni pace 
tactical	tattico tattici tactical tattica tattiche tactica strategico combattimento strategici 
discovers	scopre scoprendo scoprono intuisce rivela scoprira scoprire scoprirà svela 
uganda	uganda kenya tanzania nigeria africa zimbabwe mozambia ghana —africa 
jail	carcere prigione carcer carcerato penitenziario jail carcerano prigioni incarcera 
yeah	okay naaah aah ok so dooo ahhh ahhhh oooh 
withdraw	ritirare ritirarmi ritirara ritirarla ritirarle ritirassi ritirata ritirasse ritirarlo 
holmes	holmes thorndyke hickson frederickson mason conan poirot sherlock mistero 
promise	promessa promes promise promesse, speranza promesse promised promesso promessas 
convert	convertire converti converte conversione convertirò convertirlo converto convertirla convertir 
dos	dos os vermelha arões alhos gatões vermelho mães verdadeiro 
afternoon	pomeriggio mattina mattino mattinata sera notte pomeriggio» pomeridiano pomeriggi 
noting	notando notare affermando sottolineando lodando riguardo elogiando confermando commentando 
arrive	arrivano arrivan giungono arrivo arrivati arriv recano attenderli tornano 
warrior	guerriero guerrieri warrior guerrier guerriera dei#guerrieri stratoguerriero #guerrieri combatti 
mammals	mammiferi uccelli animali vertebrati rettili mammifere mammifferi mammifero marsupiali 
dimensions	dimensione dimensionali dimensioni dimensionalità dimensionati dimensionando dimensionale dimensioni» dimensions 
surrey	warwickshire hertfordshire buckinghamshire oxfordshire sussex surrey nottinghamshire wiltshire berkhampstead 
lutheran	luterana luterano luterani protestante evangelica evangelico luterane cattolica luter 
ports	porti port porto ports portuali navi marittimi periferiche flotte 
amy	lisa amy emily maggie jennifer carrie claire olivia megan 
survival	sopravvivenza sopravvivenze vivenza survival sopravvivente sopravviventi sopravvivere sopravvivendo vita 
responses	risposte risposta domande rispondenze reazioni commenti richieste stimoli interrogazioni 
badly	gravemente pesantemente malamente seriamente malridotto malridotta danneggiata danneggiato frettolosamente 
collegiate	college ncaa collegiate intercollegiate intercollegiale basketball college, school prep 
scandal	scandalo scandali inchiesta scandala corruzione #scandalo parascandalo affare scandalismo 
widow	vedova moglie figlia marito sposa lady contessa cugina signora 
swing	swing jackswing swinging pull combo corda backdrop grip controra 
nights	notti notte serate sere nights night weekend notturn capodanno 
polo	pallanuoto golf nuoto footgolf equitazione pallavolo canottaggio minigolf pallavi 
linda	lisa linda laura rita anita susan marcella renata barbara 
adr	bzd ptr easw abazy adr sostitutivo ysg egb kso 
consist	costituite costituiti consistono composta costituita composto costituito consta composte 
probability	probabilità probabilita probabilista equiprobabilità probabilistica probabilisti probabilistico equiprobabili aleatoria 
farms	fattorie fattoria allevamenti appezzamenti agricoltori agricoli agricole allevard piantagione 
conferences	conferenze convegni meeting conferenza congressi riunioni teleconferenze conferenti meetin 
zhang	zhang zhao liu chen zhu cheng xu liang guo 
crazy	pazzy crazy pazz impazzivo ride pazze big cool spaccacuori 
witness	testimone testimoni #testimone testimonio testimonino witness testimonianza testimony testimoniare 
nephew	nipote cugino fratello figlio zio cognato pronipote nonno fratellastro 
sensitive	sensibili sensibile delicate radiosensibili insensibili delicato estremamente delicata delicati 
mutual	reciproca reciproco reciprocate mutua reciprocità reciproci reciprocal mutuale reciprocity 
diet	dieta diete vegetariano vegetariana diet dietetic cibo dietetico dieteti 
clients	clienti fornitori cliente clientele client clients partner consulenze clientes 
fringe	fringe streaking festival pseudoscientifico sconfinata sheaffer complotto pseudoscienza a 
passion	passione passion passionfruit passionara passionato passioni passional passionada passionate 
rings	anelli anello anell anelle rings anellini anella anelloni anelletti 
millions	milione milioni miliardo migliaia milions miliardi milioni$ milion miliardi$ 
dialect	dialett dialet parlata dialetto parlato dialetti dialettu parlate lingua 
orlando	orlando miami orlandoni diego orlandos orlanda carolinas orlandu giorlando 
relay	relay staffette staffetti staffetta cronostaffetta sincrone sincro olimpica salto 
wet	umido caldo freddo wet asciutti dry freddi asciutta caldi 
cruise	cruise crociera crociere crocieri imbarco imbarchi cruises #crociera ship 
henri	henri georges françois lefrançois émilien nançois mondière fernard jean 
publish	pubblicare pubblicaz pubblicarsi pubblicarlo pubblicarvi pubblicazione autopubblicare pubblicarla pubblicarle 
joy	gioia amore gioia, allegria speranza nità felicità gioir splenda 
julia	claudia francesca julia elena flavia evelina eva valentina valeria 
kitchen	cucina cucin cucine ristorante barbecue cucini stanza guardaroba casa 
abstract	astratta astratto astratti astratte astratta» astrattivo astratto» astrazione astrattiva 
snake	serpente coccodrillo crocodile cobra roccodrillo serpentor serpenti serpenton alligatore 
comedian	comico attore showman cabarettista umorista commediografo televisivo commediante cabarettisti 
motorcycle	motocicletta motociclista motociclisti motociclette automobilista auto motoveicolo motociclismo scooter 
nadu	tamil kerala gujarat andhra india bhati nadu maharashtra maharashtri 
arsenal	arsenal arsenale arsenali arsenalotto chelsea arsenalotti arsenalul arsena ilvarsenal 
millennium	millennio °millennio millennium millennia millennio» millennial willennium shard rinascita 
assists	assist rimbalzi punti stoppate rubate assistmen rimbalzi/partita rimbalzisti rimbalzista 
bow	bow dritta bastone prua henley chariot gun poppa swore 
andré	andré landré dufilho bastier andréi benoît leandré vandré ludovic 
serie	biancoazzurra reggina foggiana foggia rossazzurra rossoazzurra retrocedente rossoblu cavese 
dimensional	bidimensionale dimensionale tridimensionale bidimensionali tridimensional tridimensionali bidimensionalità dimensionali quadridimensionale 
eurovision	eurovisione eurovision eurovisivo eurovisiva eurofestival contest eurovisión eurofest scurovisione 
suite	suite suites igsuite suiter messagepad imessage impromptu message suitei 
doug	doug bobby bill mike jim bob sam eric eddie 
gravity	gravità gravitazione gravitazionale gravitazionale, gravity antigravitazionale gravitazero gravitone antigravità 
stored	immagazzinato immagazzinati immagazzina immagazzinate immagazzini immagazzinata immagazzinava immagazzinò immagazzinabile 
departed	salpato salpati salpò sbarcato reimbarcato salpa scortati salpata rotta 
optical	ottico ottiche infrarossi ottica ottica, ottici giroscopio elettronico fotometro 
frontier	frontiera frontiere frontier frontiera» frontieres frontierland oltrefrontiera frontiers frontiersmen 
evaluation	valutazione test analisi esame valutazioni validazione #valutazione monitoraggio valutativa 
graph	grafo teorema diagramma algoritmo algebrica #algoritmo polinomio fratto algebrico 
hybrid	ibrido ibrida ibride ibridi hybrid ibridato ibridata ibridati ibridare 
oslo	oslo stoccolma copenaghen helsinki—stoccolma göteborg stavanger malmö trondheim bergen 
earn	guadagnare guadagnano guadagnar guadagnarsi guadagnati guadagna guadagnata guadagnato guadagnando 
metre	metri metro metri² metri/ iarde metri, piattaforma metriche centimetriche 
keyboard	tastiera tastierina tastierino tastierini tastiere, tasti pad tastiere voce/tastiera 
jamie	jamie andy kevin matt bobby robbie daniel sean rob 
decorated	decorato decorati decorate decorata decorah decorazioni ridecorati adornato decorano 
complicated	complicata complicato complicate complicati complessa complica complesse complicatissimo complessante 
nathan	nathan sam samuel adam josh caleb joshua aaron isaiah 
slavery	schiavitù schiavitù» schiavista schiavismo schiavitu schiavi schiaviste schiavisti schiavile 
circular	circolare circolari ellittica ellittico cerchio rotoidale rettangolo piatta sottilinea 
operators	operatori operatore gestori vettori opera, commutatori gestore v,a operatrici 
armor	corazza armatura armature armor corazz corazze corazzato corazzai armaturka 
mechanics	meccanica geomeccanica ·meccanica geometria quantomeccanica geomeccanico meccaniche dinamica motomeccanica 
bradford	nottingham leicester cottingham cotford brighton melchester wrighton #nottingham corringham 
leon	leon simone ruben arturo saloman daniele leòn salomao gil 
rachel	rachel rebecca rachele isabelle ester jessi beth megan susan 
footage	filmato filmati filmata filmate video filma filmare spezzoni foto 
strings	corde string archi bicordi plettri flauti fiato strings armonici 
header	intestazione nome_cursore cursore timestamp intestazioni sovrimposta istruzioni nome_file stringa 
hood	hood hoody mcpherson cluemaster crinsom lincoln batwing wildcat dibdin 
inspector	ispettore ispettor ispettoria commissario poliziotto ispettori polizia viceispettore sergente 
warnings	avvertimenti avvertimento segnalazioni avvisi avvertimi minacce messaggi avvertenze ammonizioni 
relatives	parenti parente famiglia famiglia, famigliari cugini famigli cognati imparentati 
plains	pianure plains pianura colline montagne deserto altopiani prateria desertica 
defended	difeso difesi difender attaccato difendendo difendeva respinto combattuto difende 
wheels	ruote ruota wheels wheel freni retromarcia /ç/ cerchioni rulli 
criterion	criterio criteri criterî critero inclusione soddisfa soddisfi requisito criterion 
ace	ace asso hurricane pilotà quicksilver hurrican nighter pilota aces 
penn	penn penns gallitto princetown raleigh washington college levity sams 
approached	contattati contattato contattata ingaggiati vistato incontrato vistata fermati notata 
joke	sciocco barzelletta barzell scherzo barzel snoo ϸ burlona storiella 
sailed	salpato salpò salpa salpata salpati navigò sbarcato salpate salpava 
religions	religioni religione credenze feligioni cristianesimo culti irreligione religioni» #religione 
grants	sovvenzioni finanziamenti donazioni sovvenzione benefici finanziamento fondi aiuti beneficî 
andrews	andrews scottis shaw hughson scotson mcandrews dunchurch bishop battiscombe 
moderate	moderato moderata moderate moderatto moderati moderat moderaterna moderated moderatamente 
stolen	rubata rubato rubati rubate rubat trafuga rubatab rubatagli trafugato 
tributary	affluente fiume confluenza tributario affluent subaffluente confluente affluenti confluent 
pin	pin backdrop guantone connettore pettine corsoio tacchetta stick paletta 
carol	carol barbara linda monica olivia carole angela rita silvia 
owns	coproprietario proprietaria coproprietaria detiene proprietario proprieta comprato proprietà comproprietario 
prototype	prototipo prototipi prototipos prototipale ᛟ preserie prototipica prototyp prototipali 
copied	copiato copiata copiati copia ricopiato ricopiata copiate ricopiati copiando 
canterbury	canterbury christchurch waverley viterbury dunstan dunstano eastchurch becket galles 
midnight	notte mezzanotte mattino mattina sera night giorno notturno notturn 
quarterback	quarterback cornerback nfl quarterbacks quarteback linebacker lineback runningback linebackers 
duchy	ducato duchi prussia granducato #ducato duca pomerania neumark brzeg 
bailey	bailey manderson mason harrison bennett griffin barrison sanderson bonsey 
arbitrators	amministratori votar votanti decisioni astensi #ni votano astenervi insindacabili 
performers	cantanti musicisti danzatori attori artisti ballerini coristi musiciste esibizioni 
handled	pesato operati gestite gestiti utilizzati ciati supervisionato curati maneggiato 
exploration	esplorazione explorazione esplorazioni esplorare esplorativa avventura esplorativo esplori esplorativi 
diversity	diversità biodiversità geodiversità vivenza ecosostenibilità diversità» multiculturalità biodiversita ambiente 
sixteen	sedici dodici tredici twenty diciotto quattordici dieci eight diciassette 
repeat	ripetuto ripetere ripetuta ripetendo ripeter ripetersi ripete ripetervi ripeterne 
brussels	bruxelles bruxelles, bruxell ,bruxelles bruxelles» bruxellese parigi bruxellis bruxellois 
imdb	imdb mymovies movieplayer film /film cinema/film film/tv funnymovie movieplay 
planets	pianeti pianetini pianeta #pianeti planetari pianetino planetoidi planetare pianeti» 
theatrical	cinematografica cinemateatro teatrale cinema cinematograﬁche teatro animazione spettacolo cinematografo 
reconnaissance	ricognizione ricognizioni ricognitore ricognitori ricog fotoricognizione ricognitiva reconnaissant ricognitore/bombardiere 
shots	colpi sparate inquadrature shot scatti scene fotogrammi sparatori inquadratura 
complaint	accuse denuncia lamentela reclamo querela rchiesta accusa lamentele violazione 
batman	batman superman batman» superman/batman catwoman batgirl bruce/batman jla/avengers batman/superman 
exhibited	mostra esposto esposte esposta esposti mostrato esposizione esposizioni esposi 
espn	espn news espn+ eurosport telecronista sports sportitalia telecronisti commentatore 
investigate	investigare indagare investiga indaghi indaga investigazione investiganti indagini indagine 
verify	verificare verificarne accerti attesti accerta accertarne comprova accertare comprovare 
discontinued	reintrodotto dismesso sostituita cessato reintrodotta cessata sostituito commercializzata introdotto 
absent	assente assenza assenti privo presente assentire assent priva eccetto 
girlfriend	fidanzato fidanzata ragazza amica coinquilino vicky coinquilina vicki mona 
resignation	dimissioni dimissione dimissionamento dimissionari dimissionato dimissus dimissionati dimissionario dimessosi 
fossil	fossile fossili fossilis fossilifero fossilifera helixfossile fossilizza fossiliferi subfossile 
explaining	spiegando spiegalo spiegare spiegazione spiega spiegazioni spiegasti spiegar spiegano 
tang	tang ming yuan zhou qing wu han zong xia 
inches	pollici millimetri centimetri cm centimetro larghezza millimetre millimetro centimetrico 
proven	dimostrato dimostrata dimostrati dimostrate dimostrar dimostrami provata dimostrare dimostrabile 
franco	franco spagno italo spagnola balcazar ispano ispagna francesi pastro 
dying	morire morente morto muore morte morendo agonia dead morira 
tribal	tribale tribali tribù tribù» —tribù tribalat indigeno triballi triballo 
tyler	tyler jessi dean jeff ashley jamie travis craig callahan 
surrender	capitolazione tregua resa assedio capitola armistizio arrende» prigioniero ultimatum 
glenn	glenn glenny ken bert marcus dan billy brad larry 
substance	sostanza sostanze sostante contenuto materia psicotrope stupefacente essenza pseudoefedrina 
focusing	focalizzato focalizzata focalizzando focalizzandosi focalizzarsi focalizza focalizzati concentrandosi concentra 
luxembourg	lussemburgo belgio francia francia, luxembourg lussemburgo}} lussemburghesi germania austria 
colored	colore colore, colorato colori colorati arancio blu colorata bianco 
administered	amministrato amministrata amministrate amministrati gestito gestite controllati istituiti gestita 
explosion	esplosione implosione esplosioni bomba detonazione disastro esplodo incendio implosion 
pushed	indietreggiato indietreggiata spinto spinti spinta allentato pressato spingendo fermato 
generations	generazioni generazione generazionale generazionali generazioni» discendenti progenitori capostipiti generation 
duck	anatra coniglio gatto salmì topolino canarino struzzo ranocchio daffy 
porter	porter dobbin selfridge cole mason foster fisher dobbins calley 
permanently	permanentemente temporaneamente momentaneamente indefinitivamente permanente completamente permanente» temporanemente temporaneo 
memphis	memphis macon orleans houston lafayette philadelfia atlanta chicago, chicago 
salvador	salvador vador vicente guatemala maragua panamá carlos honduras salvadora 
emma	emma francesca rebecca elisa elisabella emily nadia gelinda anna 
mit	mit irrlicht stanford hochlicht universität pische berkeley im harvard 
zoo	zoo zoologico acquario bioparco parco zoog elefante giardino elefanten 
gibson	gibson turner fisher harrison anderson mck graham gridley horton 
emerging	emergenti emergente emergendo nascente nascenti emergere nuovi emergent promettenti 
mere	mere mera warz mero effimero irreality apparent meray nothing 
notre	notre dame juilly damier bonsecours cloître vierges orbonne saints 
portions	porzioni parti porzione parzialmente frammenti porzionato porzionari interamente zone 
macedonia	macedonia grecia bulgaria serbia macedonia, albania bosnia croazia erzegovina 
ethics	etica etico etici deontologia bioetica filosofia scienza moralità etiche 
curtis	curtis greene gallison russel allison carter greenshaw marrett wright 
rescued	salvati salvato salvata catturata annegati recuperata soccorsa recuperati annegata 
gaelic	gaelico gaeli gaelica gaelici gaelic irlandese gaelico/ gaeliche irlandesi 
slovakia	slovacchia ungheria slovenia polonia slovacchi ungheria, romania croazia croazia/ungheria 
elevated	elevato elevata elevati elevazione rango sopraelevata alti retto elevatosi 
jeremy	josh jeremy jason nick shaun ian aaron rob nicole 
listen	ascoltar ascoltare ascoltarti ascoltaci ascolta ascoltarsi ascoltalo ascoltami ascoltare» 
impressive	impressionante straor eccezionale impressionanti eccell straord spettacolare ottima stupenda 
bradley	bradley warren griffin dwight gwynneth southerly spradley grady dwiggins 
surely	sicuramente g# how no, immgini certamente altrimenti veramente i& 
egg	uovo uova gallina grattage pescera egg cova pesce corn 
conquest	conquista conquest conquesta conqu conque conqueste conquis conquisto conquistatore 
rod	rod bocca spinotto gene vibro vibratore pinza bastone townend 
cdp	cdp miglio censimento /km² abitanti/km² contea census designated persone/km² 
algorithm	algoritmo #algoritmo algoritmi algoritmica algoritmico algoritmic algoritmici teorema metodo 
burn	bruciare brucia bruci burn bruciata bruciatura bruciate bruciano brucio 
thesis	tesi dottorato dissertazione dottora addottorato laurea postdottorato phd dottorale 
lover	amante seduzir lover amore seduzione loverso seduttore amanti bacio 
capitol	capitol campidoglio ashville downtown tamiami sudio washington nashville pitol 
remembered	ricordato conosciuto ricordata noto famoso ricordati ricord conosciuto» amati 
ferdinand	ferdinand ferdinando ferdinandos ferdinando, ferdinands ferdinánd ferdin ferdinandovich leopoldo 
marshal	maresciallo felmaresciallo vicemaresciallo marescialla marescialli federmaresciallo maresciallato colonnello tenente 
judaism	ebraismo giudaismo ebraica ebraismi cristianesimo rabbinismo ebraismo» rabbinic ebreo 
balls	palline palle palla pallina pallini barattolo bastoni sticks birilli 
nacional	nacional racional nacionale cinenacional binacional nacionalidad república nacionales nacionalinė 
wrestlers	lottatori wrestler wrestlers wrest lottati wrestle wrestlng lottatrici lottatorie 
ahmed	ahmed mohamed mohamoud hasan mohammed ibrahim hassan rahman rashid 
sin	peccato, peccato dio, peccat castigo 麻瓜 yio espia peccati 
holocaust	olocausto shoah holocausto olocausti olocausto» holocaust nazisti olocaustico auschwitz 
edgar	edgar harold edgaro edgard rold moroldo arturo arthur artura 
saxophone	contrabbasso percussioni sassofono flauto percussio tromba contrabbassi trombone pianoforte 
retain	conservare mantenere mantenerne conservarne conservando mantenuto mantenendo mantengono mantiene 
curriculum	insegnamento istruzione educazione scuole educazioni educazionale lezioni coeducazione scuola 
wishes	desideri desiderami desidera desiderio volontà prega esaudisce esaudire esorti 
prepare	preparare preparar preparazione prepar preparasi prepararsi preparsi prepararle prepara 
ruins	rovine ruderi rovina castello ruins fortezza rovin diroccata diroccati 
ibm	ibm supercomputer microprocessore microcomputer microprocessor apple minicomputer computer microsoft 
rochester	rochester eastchester winchester boston worcester cleveland westchester williamsville binchester 
nigerian	nigeriani nigerina nigeriana nigerini nigeriane nigerino nigeriano tanzaniana ghanesi 
jesse	jesse sam travis tommy jason aaron rick dean dustin 
malaysian	malese indonesiana thailandese indonesiani malaysiani malaysiano indonesiano tailandese malesi 
atlas	atlas atlante atlantean atlantea atlanten falcon atlason ‘atlas atlanto 
telegraph	telegrafo» telegrafo telegraph telegrafia telegraphone telegrafata telegrafato telegraf telegrafava 
performer	performer attore/cantante ballerino performance danzatore cantante/attore attore/attrice perfomance cantante 
cannon	cannone cannoni pistole cannon gatling fucile armi fucili proiettile 
encounter	incontro #incontro incontro/scontro #avventure #scontro scontro/incontro avventura #avventura incontrare 
emily	emily francesca emma julietta alice laura amelia caroline hannah 
dissolved	dissolto disciolta dissolta disciolto sciolto dissolti sciolta disciolti discioltosi 
catalogue	catalogo catalogue collezione cataloga catalogum catalogò cataloghi patalogo catalogi 
discrimination	discriminazione discriminazioni discrimini discriminatorie antidiscriminazione discrimina discriminò discriminatore discriminazione» 
myspace	myspace myspacetv //myspace youtube facebook thefacebook twitter sito instagram 
reveal	rivelare svelare rivelando svela scoprire svelano riveli rivelar svelando 
wizard	mago wizard stregone magicman magica stregato magil gno magico 
teen	teen teenager teenagers adolescenti adolescenziale preadolescente preadolescenti adolescente girl» 
spots	arancioni occhi notti macchie chiazze puntini puntinati scura scuri 
bomber	bombardiere bombardieri raf bombardiera cacciabombardiere cacciabombardieri bombardiere/aerosilurante aerosilurante/bombardiere bombardiers 
foods	alimenti cibi alimentari bevande sapori ingredienti latticini latte formaggi 
quest	avventura donnavventura adventure #avventura adventureland tesori avventura/azione avventure talismano 
connor	connor ronan eamon kelly cassidy rickler ryann mcgarrett donnell 
screenplay	sceneggiatura ,sceneggiatura film regia/sceneggiatura sceneggiaturamiglior ,film sceneggiatura» sceneggia sceneggiato 
motors	motors motori automobili automotori diesel automotive magneti motor propulsori 
minimal	minimale minimali minimanente limitato limitante limitati limitativo minimal minimi 
muscle	muscoli muscolare muscolazione muscolo muscolone muscolatura muscolari muscolarità muscolata 
prestigious	prestigioso prestigiosi prestigiose prestigiosissimo prestigiosa prestigiosissima prestigiosissimi prestigiosissime prestigi 
sustainable	sostenibile ecosostenibile ecosostenibili sostenibili ecosostenibilità sostenible sostenibilità sostenibile» sostenibilmente 
chelsea	chelsea liverpool manchester fulham londinese tottenham watford /liverpool londra 
strict	severe rigorose rigorosa regole rigoroso rigorosi severa restrittive ferree 
kingston	kingston kingstone kingstonian duddingston colnbrook kingsthorpe keston kingstonians lowton 
sheep	pecore bovini cani bestiame bestiami capre bovino ovini mucche 
andrea	andrea angela silvia laura francesca veroni annalisa rosanna renata 
complaints	lamentele proteste richieste denunce reclami accuse lamentela contestazioni rimostranze 
connects	connette collegano interconnette collegando collegato connetteva connetta collegante collegandosi 
nursing	ospedaliero infermieristico infermieristica pediatrico infermiere infermieri ospedaliera ospedaliere ospedalità 
defenders	difensori difensor difese difesi soldati difesa assediatori nemici uomini 
richardson	thorner robertson shaw roberts johnson taylor sackett sanderson wilkinson 
triangle	triangolo cerchio #triangolo triangoli triangolo/mi equiangolo triangle rettangolo triangi 
nato	ue onu navfor comint balcania urss ksf jasdf iugoslavia 
teeth	denti ossa unghie osso dente teeth dita zanne mascella 
occasional	occasionale occasionali occasionalmente saltuarie saltuariamente sporadico sporadica sporadicamente saltuari 
strictly	rigorosamente esclusivamente essenzialmente unicamente necessariamente regole restrittivo specificamente strettamente 
harper	harper blair gidden sharper stephe fisher taylor steedman bellom 
fluid	fluido fluido, fluidi liquido fluidic fluida liquido, fluidostatica viscosità 
fed	alimentato alimentata alimentati alimentate alimeni alimentava alimenta alimentazione pompata 
newfoundland	canada labrador scotia canady québec terranova groenlandia canadia scozia 
disbanded	ricostituito sciolto ricostituiti sciolta ricostituita ricostituitosi ricostituitisi ricostituite disciolta 
comparable	paragonabile comparabile paragonabili comparabili equivalente imparagonabile equivalenti confrontabile simile 
documentation	documentazione documenti documentazioni documentale documentino archivio documentativo documento documentation 
brien	connor ronan donnell neill brett brien patrick shea brennan 
compounds	furani composti terpeni catalizzanti solfiti solfoni diterpeni terpenici nitrofurani 
pointing	rivolto puntanto puntato colpetto dito puntante rivolti punta» bocca 
edmund	edmund edward enrico ælfred giacomo tommaso edelberto edmun geoffrey 
naturally	naturale naturali naturally artificialmente naturi spontaneamente naturalmente naturale, particamente 
forcing	costringendo costringendolo costringendosi costringendoli obbligando costringo costringi permettendo forzando 
ussr	urss sovietica sovieti sovieticarussia sovietico» sovietico sovieto sovietici sovietica» 
laser	laser fotonico radioguida blaser beam infrarossi luminoth microonde fotonici 
lat	lat runc keum imum vat min pol tłum wro 
sculptor	scultore sculto pittore scultone scultori ceramista scultoria scultorio artista 
guild	guild corporazione gilda sindacato gilde stellario apprendista lucasgilde gild 
observer	osservatore osservatore» guardian bombardiere/osservatore panorama» reporter cannocchiale osservatore/puntatore aereo» 
worlds	mondi mondo universi universo worlds eworld battleworld worldsf orld 
imprisoned	imprigionato imprigionati prigione incarcerato imprigionata rinchiuso prigionia incarcera prigion 
wrestler	wrestler lottatore wrestle wrest lottatori wrestlers wrestlecrap wrestlng wrestling 
praise	elogi plauso apprezzamento apprezzamenti apprezzami lodando lodato critiche entusiaste 
parishes	parrocchie parrocchia parrocco parrocchiali parrocchiano parrocchiane viceparrocchia parrocchia» parrocchiana 
bones	ossa osso bone bones costole scheletro crani scheletri scheletrito 
css	css cssml ncss dcss decss font impostato navigazione layout 
cox	cox lewis mck jacox scox price selfridge liley nickson 
contracts	contratti contratto contrattuali lease contrattualmente contrattuale contrattazioni contratte stipulate 
consequences	conseguenze seguenze conseguenze» cause rischi ripercussioni implicazioni concause conseguenziali 
provisions	disposizioni clausole norme legislazioni 중구 legislazione emendamento abrogazioni regolamenti 
circulation	circolazione bimensile periodico bimestre mensile circolo» circolante circolazioni tiratura 
butterfly	farfalla farfallista farfallino farfallina butterfly farfallini farfallone farfalline beautifly 
hugo	hugo oscar césar aldemar victor charlos césario julio gabriel 
abolished	abolito abolita aboliti abolità abolite reintrodotto abolì reistituito soppresso 
algeria	algeria marocco tunisia algerica algerina libia mauritania giordania nordafrica 
edu	edu unibo html/ unibg itp //easyweb html#p indirizzo //pl 
sufficiently	sufficientemente abbastanza estremamente talmente suffcientemente sufficiente sufficienza particolarmente insufficientemente 
armies	eserciti esercito truppe armate forze armata legioni battaglie comandate 
separation	separazione separazioni #separazione separazione» separation separativi confinamento separabilità separativo 
spy	spia spiona spionaggio segret spioni segreto spy spie spionaggi 
cliff	rupe scogliera cliff precipizio dirupo roccia massi crepaccia mone 
technically	tecnicamente teoricamente formalmente èer virtualmente informalmente essendo ugualmente sia 
reactions	reazioni reazione catalizzanti acilazioni alchilazioni ossidoriduzioni reagite interazioni reattivi 
lithuanian	lituana lituani lituano polacchi bielorussi lituane lituania lituanica polacca 
trick	trick shot trucchetto draw skips backdrop backflash penalty blueno 
curve	curva curve curve#curve angolo tangente equazione spigolo direzione m,a 
accidents	incidenti incidente disastri incidenze #incidenti disastro incidentali conseguenze deragli 
horizontal	orizzontale verticale verticale/orizzontale orizzontali verticali verticalmente orizzontalmente vertica mmorizzontale 
legends	leggende leggenda legends leggendari leggendario leggendarie saghe mitico xks 
enzyme	proteina apoproteina fosfoproteina proteino proproteina emoproteina citolo proteinaa proteinasi 
freight	merci passeggeri treno ferroviario trasporto ferrovia treni cargo traffico 
hydrogen	idrogeno idrogeno/ossigeno ossidrogeno metano ossigeno gasso bioidrogeno diidrogeno diossigeno 
broadcasts	radiotv trasmetter radiotelevisioni radio trasmette televisioni trasmissioni irradio trasmettere 
viii	iii iv ii vii viii ix xii xi iii° 
caroline	caroline francesca elena carlotta ludovica carlotte charlotte carolines marianna 
pull	tira push backspin pull spingi muovere lift strappo stop 
plymouth	plymouth portsmouth ranchester cotford granchester dunchester bristol ipswich northampton 
twentieth	ventesimo diciannovesimo xx novecento xix novecentesimo secolo millenovecento #novecento 
cuts	tagli taglio cut tagliar tagliante tagliare taglie\ tagliati tagliandi 
mediation	mediazione conciliazione negoziazione arbitrato #discussione decisioni #conflitti richiesta trattative 
catalog	catalogo cataloga catalogò patalogo cataloghi catalogazione #catalogo collezione catalogs 
dale	dale larold cliff ronney kenneth pelyn malcolm ronna secondino 
synthesis	sintesi sintetizzazione sintetizzare sintetizza sintetizzi catalizzanti sintetizzo sintesis catalisi 
rape	stupro violenza stupri omicidio aborto infanticidio feticidio incesto uccisione 
seoul	seul tongyeong seoul pechino pyeongyang tokyo yeongyang pusan mungyeong 
engagement	negoziazione fidanzamento schermaglia azione battaglia partnership negoziazioni matrimonio conversazione 
coin	moneta monete moneta» monetam denario monetale biglio rovescio monetis 
lucy	francesca lucy cecilia emma mary agnes clara lisa olivia 
platinum	platino platina platin platinum platine multiplatino platinite platinoti diamante 
twins	gemelli twins gemelline gemellini gemelle sorelline sorelle bambine twinsun 
memories	ricordi memoria emozioni memories memorie memori memory pensieri memoria, 
robertson	robertson andrews stewart mccolm mitchell campbell mck mccullen reid 
verified	validato accertata comprovato validati validate comprovati validata verificata verificato 
anthology	antologia antologio antologie antologico antologica antologi antologizzata antologici anthology 
milton	milton teston rilton dilton keynes gilton ralph passos miltone 
geological	geologico geolog geologia geologiche geologici geologica geologix geologi geola 
defining	definire defini definizione definibile generico generica inclusione elemento fondamentali 
dinner	pranzo cena banchetto colazione ricevimento pranza pranzi compleanno festa 
hosting	ospitare ospitando web intrattenimento ospitate ospità ospitato ospitata forum 
thriller	thriller poliziesco thriller/horror horror/thriller film thriller/drammatico drammatico horror thrillers 
retreat	ritirata contrattacco ripiegamento accerchiano accerchia accerchiamento ritirarsi accerchiarli ripiegare 
albany	richmond albany washington princetown williamsburg grovetown richmondi bedford charleston 
abdul	rahman muhammad abdul muhammadu #muhammad ammad muhamad ahmad rahmàn 
ignore	ignorare obbedisci ignora sbagliamo no, ignor @a contestarti ignori 
migration	migrazione migrazioni migrate migrandi migrata migrato migrava immigrazione migranti 
carefully	accuratamente attentamente scrupolosamente accurato minuziosamente attento preventivamente equilibratamente pazientemente 
magnitude	magnitudo magnitude 亮 luminosità grandezza magnitudini apparente epicentro intensità 
sudan	sudan uganda ciad africa gibuti tanzania libia —africa etiopia 
manages	riesce gestisce progetta riusce offre tenta incarica pianifica affida 
duration	durata durate intervallo μs periodi ore intervalli indeterminato pause 
henderson	henderson gilton pearson mitchell mck mcdonald mcclair vanderson nelson 
explorer	navigatore esploratore explorer esplori esplorino circumnavigatore esplorazione navigator esploro 
marco	marco luca daniela ventura matteo campagnaro fabrizzi santonio alberto 
fusion	fusion fusione power fonder powermove tact fondere nucleare liquid 
aids	aids hiv hiv/aids disabilità cancro aids/hiv cecità prevenzione malattie 
gathered	radunati radunato radunata raccolto raccolti radunatasi raccoltosi radunate raccoltasi 
privately	privatamente privata, privata privato privati privatair private comprato riservatamente 
reflected	riflette influenzata rifletteva rifletto riflettono influenzato percepito riflettendo influenzati 
afraid	paura contento desiderami sincere te… lamente fidar pensa desiderare 
presbyterian	metodista anglicana presbiteriana presbiteriano anglicano protestante presbiteriani pentecostale cattolica 
automobile	automobile automobilia automobili automobilista automobil auto automobilina automobily automobile» 
fault	fault fagli faglia fagliamento errore filla quasto flagaggio catena 
pound	pound dollaro barattolo pounds moneta barile testone libbre grammi 
allegedly	accusato presunto sospettato accusati accusata accusate accusa accusava falsamente 
delay	ritardo ritardi ritarda ritardo/anticipo segnale rallentamento ritardate ritardare μs 
developers	sviluppatori sviluppatore programmatori kauppatori developer progettisti software creatori jdeveloper 
semifinals	semifinali quarti #semifinali semifinale semifinal semifinals finale finali semifinito 
belfast	dublino belfast dublino, glasgow cork irlanda edimburgo irland dublin 
arctic	artico artide artica ghiacci artiche antartici antartide alaska antartic 
kurt	kurt wolfger ulrich klaus kaufmann karl weder jungermann wolfgang 
mayors	sindaci #sindaci capoluoghi governatori municipali presidenti città vicesindaci citta 
windsor	windsor westminster sandringham buckingham kensington bedford keston richmond falconbridge 
assumption	concezione cristo, ipotesi assunzione presumption io, supposizione sussunzione assumption 
plates	piastre placchetta fogli placchette placce placche placcati rotoli lastre 
fourteen	quattordici sedici dodici tredici dieci cinque diciassette diciotto nove 
monroe	monroe madison calhoun perry adamsville lafayette williamsville hampton washington 
hearts	cuori hearts cuore bravehearts cuore, heart #cuori junkhearts hearth 
belgrade	belgrado belgrad delgrado zagabria sarajevo belgrade serbia niš #belgrado 
victories	vittorie vittoria vittoriosi successi vittoriose vittoriosa sconfitte vittorie, vittorioso 
pale	scuri scuro marrone scura grigio occhi brizzolato rosato verdolin 
pursuit	inseguimento inseguimenti pursuit seguimento inseguim individuale caccia conseguimenti pursuits 
glory	glory gloria, glora gloria splendora glor splende splendi glorie 
destroyer	incrociatore cacciatorpediniere cacciatorpediniereincrociatore cacciatorpedinieri sommergibile cacciasommergibile portaerei hms nave 
deeply	profondamente profond profondo profondamento profondi profonda» profondata fortemente profonda 
affiliate	affiliata affiliati affiliato affiliare riaffiliata affilia affiliate affiliano affiliante 
preston	egton preston walsham hannaford thursford farhampton dadford northington notthingham 
deceased	defunto deceduti defunti defunte defun morto defunta tomba scomparso 
speaks	parla parlato parlan parlava parlano fluenta parlak parlantina parlant 
gathering	raduno riunione radunata radunatasi raduni summit radunare raduna riunioni 
angry	arrabbiati arrabbiato urla grida brutally arrabbiate lamented arrabbiata gridai 
incomplete	incompleto incompleta incomplet incomplete incompleti mancante incompletamente completo parziale 
enrolled	diplomato studiato frequentato diplomatosi iscritto diplomandi diplomata diplomandosi diplomando 
configuration	configurazione configurazioni configurazionale riconfigurazione configure configurato configurazionali configurati configurata 
brad	rick zach matt brad travis kris dan jeff eric 
skill	abilità destrezza bravura padronanza doti eccell talento maestria skill 
intense	intenso intensi intense intensa sintensi intensissimo intensissimi forte intensify 
tasmania	tasmania queensland tasmani australia #queensland tasmanica tasman zelanda steensland 
commitment	impegno solidarietà #impegno versalità tangibilità nità sperienza dedizione ità 
loved	amati amato grati passionato baciati amai amava passionate spassionati 
reforms	riforme riforma modernizzazioni riorganizzazioni modernizzazione riformanze riformare rimodernizzazione riformò 
rulers	sovrani regnanti governanti monarchi dinastie regni dinasti regnante dinastia 
uruguay	argentina uruguay brasile cile paraguay/uruguay paraguay colombia bolivia _uruguay 
sustained	lesionato colpito grave cedimento infartuato gravemente colpita gravi riacutizzato 
napoleon	napoleone napoleona bonaparte napoleon napoleoni napoleons buonaparte napoleonide napoleone» 
confirm	confermare conferma confermarvi confermalo confermarne confermarlo confermami confermavo verificare 
breed	razza cani allevatori allevatore levriero canina cucciola levrieri allevati 
auxiliary	ausiliari ausiliaria ausilia ausiliario ausiliarie ausiliares ausiliare ausiliarietà ausiliatore 
enabled	consenti abilitata consentito consentir permesso permetter consento permette supportato 
discography	discografia #discografia discografie discografici discografice musicalidiscografia album discografiaformazione tracklist 
licence	licenza autorizzazione licenze patente gioco,licenza superlicenza permissione licensa autorizzazzione 
refugees	profughi rifugiati profughe migranti sfollati immigranti prigionieri umanitari emigranti 
adrian	adrian alex marco fabrizio davide stefano mark daniele riccardo 
pipe	pipe mantice stovepipe pipes canne soffietto cric lapipe pead 
karen	karen laura lisa kristin amy leanna linda cathy ellen 
altered	modificato modificata alterato alterata cambiata modificati modificate cambiato alterate 
budapest	budapest budapest—miskolc—budapest vienna budapester budapest—debrecen—nyíregyháza—budapest budapesten belgrado budapesti budapešť 
designers	designer progettisti designers design disegnatori architetti stilisti progettista webdesigner 
heir	erede primogenito figlio terzogenito nipote secondogenito eredi pronipote cugino 
advisor	consulente consigliere ambasciatore assistente ambascia vice advisor funzionario ambasciatrice 
illustrate	illustrare illustra illustrazione illustrante illustrativo illustrarlo illustrarla illustrarne illustrarle 
authorized	autorizzata autorizzato autorizzati autorizzate richiesto ratificata autorizzò autorizzazione autorizzante 
hide	nasconder nascondere nascosta nascondino nascondi nasconderle nascoste nasconderli nasconditi 
announcement	annuncio annunciata annuncino presentazione comunicato annuncò annunciasse annunciate annunciati 
compact	compatto compatta 하는 compatti compatte compact compactpci paracompatto compacto 
tissue	tessuti epidermide tessuto tessutale epidermico cellule cute citolo tumorale 
particles	particelle microparticelle particelli particellari particella astroparticelle particella, quasiparticelle superparticelle 
refuses	rifiuta chiede accetta prega ordina pretende acconsente insiste decide 
receiver	ricevitore ricevitori ricezione ricevitoria radioricevitore ricevitorie receiver ricevitore/trasmettitore radioricevitori 
civilians	civili soldati feriti vittime prigionieri ostaggi rappresaglia miliziani massacri 
marsh	marsh paludella waterwood palude piovanello prateria rovia hedgecock bushby 
vinyl	vinile vinili cd cd/vinile tracce cofanetto lp cassetta vinil 
delayed	ritardato posticipato ritardi posticipata ritardata ritardo ritardati ritardate ritarda 
encountered	incontrato incontrati scontrato incontrata scontrati avvistato affrontato esplorato scontrata 
wednesday	venerdì sabato mercoledì mattina domenica lunedì venerdi giovedì lunedi 
chilean	cilena cileni cileno peruviani boliviani argentino ecuadoriani venezuelani peruviana 
chambers	camere camera camer carter alcova camerer loggia gass camers 
demo	demo tracce traccia live tracklist 고 intro cassetta live/dvd 
agrees	accetta chiede propone vuole acconsente rifiuta prega convince ordina 
ahmad	ahmad muhammad shabir mukhammad nasir rashid mohammad baqi muhammadan 
santos	santos fernandinho oliveiro queiros reira dias rodriguiz fernandão marinho 
paying	pagar paga pagare pagando pagati pagata pagamento pagato pagat 
interpreted	interpretate descritti descritto espressa spiegati definito interpretabile interpretabili definita 
submit	richiesta, inviar seleziona richiesta indetto richieste richiesta/risposta seleziono richiedere 
desired	desiderata desiderato desiderate desiderati desiderat desiderativo desiderabili desiderami ottimale 
followers	seguaci discepoli adepti fedeli fanatici devoti leader sostenitori adoratori 
observatory	osservatorio astronomico observatory telescopio radiotelescopio observatorio astronom astronomicon radioastronomico 
problematic	problematica problematico difficile inappropriata inappropriati inappropriato difficolta difficoltosa complicata 
springfield	springfield winchester springfields #springfield stringfield grovetown woodstown shelbyville lingfield 
kit	kit maglietto ᛟ vup maglietti giubbotto vgcs taglietto badge 
remarks	commenti discorsi commentini critiche commento commentino considerazioni lamentele accuse 
burton	granger burton crowthorne jones mansworth hannaford ashby hawthorne lansford 
inns	mor cerretani baili nepia oram bsam navan brands fenagh 
monarch	monarca regnante sovrano re monarch monarchi corona principe reale 
observations	osservazioni #osservazioni misurazioni osservazione osservative astronomiche osservazionali osservazioni» observatis 
beetle	coleottero spider ragno ceratinella pipistrello furcula floronia chirottero coleottero/volante 
promised	promesso promise promessa promessas promessagli promesse, promised promiseland promessa» 
palomar	palomar telescopio velàzquez velásquez helin ⁿ astronomo corralejo fresnedo 
cream	cioccolato cioccola panna limone cioccolati caramello cioccolata cioccolate vodka 
presenter	conduttore televisivo presentatore telegiornalista conduttrice presentatrice opinionista conduttrici ⁱ 
potter	potter potte harry potterton potter#madama tonks potter#little potterume filosofale 
copyvio	copyrigh copyvio copyright copyviol violazione copyrigth copyrigt copyr copiato 
favourite	preferiti preferita preferite favoriti prediletta preferito favorite favorit prediletto 
transformation	trasformazione trasformazionale ritrasformazione #trasformazione #formazione involuzione transizione trasformazionali transforma 
mcdonald	mcdonald mcdonalds mcdonaldland mcdoo burger macler mck #mcdonald mccann 
bavaria	baviera bavarese austria baviera, ansbach germania neuburg straubing königsbach 
kumar	singh kumar bhati bhat madhav bhi bhatti indiano arjun 
nineteenth	xix diciannovesimo ottocento ventesimo xviii secolo xvii° lʼottocento settecento 
severely	gravemente danneggiato pesantemente danneggiata danneggiati danneggiate danneggiatosi colpito seriamente 
gaining	guadagnando ottenendo guadagnato guadagnatasi guadagnare guadagnandone ottenenendo guadagnata riguadagnando 
mixture	miscela miscuglio miscelando mescolato miscelati mescolata miscelano miscugli miscelata 
browser	browser browsers firefox browsergame schermata anybrowser rowser explorer toolbar 
mate	compagno mate everafter partner galleon fofo gregario caters pin 
everybody	everybody be… okay tutti… te… me/non somebody tutti #everybody 
lyon	lione lyon parigi marsiglia bordeaux lille montpellier valence tolosa 
illustration	illustrazione lustrazione illustrazioni illustrante illustrata illustrativo copertina illustrato illustratio 
kyle	kyle matt alex damon brett chad kevin justin ryan 
afl	afl nfl usfl franchigia ravens dolphins aafl mlb lega 
brook	waterwood brook monticello torrente mill stony riva river roggie 
geometry	geometria matematica geometrie geometrica topologia geometre algebra geometrizzazione geometriam 
ping	ping pong weiping piao feng wui huang liang qiushuang 
aggregate	punteggio complessivo reti scarto netto preliminari parità risultato casalingo 
variants	varianti versioni variante sottovarianti tipi #varianti versione arianti combinazioni 
baroque	barocca barocco barocchi barocchio rinascimentale tardobarocca rococò barocche tardobarocchi 
iso	iso fips standard codici iso/r liq tandard ansi standardizza 
collapsed	crollato crollo collassato collassò crolly collasso crollata collassati crollasse 
integral	integrante integrale, integram fondamentale integral integrali integrale integralità funzione 
jake	jake zach matt danny josh charlie finn shane sam 
hopes	speranze speranza speranzosa speranzose speranzosi speranze» sperando speraw speranzoso 
cornell	yale harvard cornell university università stanford laureanda princeton amherst 
modes	modalità modalita modalit modalitá tipologie opzioni impostazioni configurazioni multimodalità 
servant	servo servitore servant funzionario nobiluomo servitor custode lord paggio 
kenny	kenny joe jerry bobby alex willie bart kris johnny 
hurt	te… paura no, 小鬼 bother piangi arrabbiato sopporto pianger 
maker	fabbricante costruttore fabricante artigiano fabbricar fabbricano fabbricanti fabbricando venditore 
inline	inline motore mivec motori tag corredato note vgc citazione 
carlo	marignani capecci cipriani parrinelli costanzi borelli montecarlo caraccioli giombelli 
lynn	glorianna laura rafaella giulian gloria barbara linda tyler allison 
stability	stabilità equilibrio inequilibrio stabilizzazione instabilità equilibro protezione coesione bilanciamento 
hoping	sperando speranza speranzosa cercare cercando speraw speranzoso aiuto appresto 
imposed	imposto imposti restrizioni imposte tassato imposta sanzionata 麻瓜 tassati 
confusing	complicato confusioni confuso complicata confusi confusissimo confondo impreciso confusivo 
summaries	riepiloghi riepilogo commenti riassunto sommari sommario riassuntivi riassuntivo commento 
beetles	coleotteri ragni notteri insetti neotteri vespidae coleottero chirotteri bruchi 
joel	joel aaron ruben daniel eric riccardo sam saul jonatan 
jets	jets palloni eagles falconi thunderjet aviogetti αjet giants skyjet 
logos	loghi logo marchi simboli edp magliette colori insegne brand 
vital	importante importantissimo essenziale vitale fondamentale cruciale vitali indispensabile importantissima 
malcolm	malcolm malcom donald colin gordon arold oliver stewart malcolmi 
winnipeg	montreal winnipeg montréal edmonton toronto calgary ottawa saskatchewan canadi 
kilometers	chilometri kilometri km kilometre chilometro kilometro kilometrica chilometrici chilometrico 
songwriters	musicisti cantautori cantanti parolieri artisti compositori musiciste cantantautore produttore/musicista 
buddhism	buddhismo buddismo buddhista buddista buddhi buddhisti theravada taoismo buddhiste 
nose	naso retraz testa muso orecchio retratto labbra nose schiena 
respected	influente influenti rispettato apprezzato autorevole rispettati considerato reputato apprezzati 
pace	veloce velocio ritmo velocissimo veloci rapido velocissima lento slow 
thunder	thunder tuono thunderhead lightning thunderhawk lightnings thunderstrike thundra thunderheart 
centered	centro centrato incentrato orientato centrati focalizzato centrata incentro incentrata 
physicians	chirurghi oculisti medici urologi ginecologi cardiologi dottori farmacisti oftalmologi 
bolivia	bolivia cile ecuador colombia argentina perù bolivie venezuela brasile 
forget	dimenticar dimenticare dimenticarti no, te… così/il dimentica così/tu amo/il 
implies	implica denota implicit implicita supponendo implichi ¬φ asserisce t+v 
crops	coltivazioni colture grano frumenti frumento cereali agricolture coltivar coltivazione 
halifax	halifax northborough painswick plymouth coventry kingsborough carhampton portsmouth penswick 
toll	pedaggio pedaggi strada fastrada ponti autostrada ponte morti attraversamento 
monk	monac monaci monastery monaster monasta monaco, eremita monk monaca 
extraordinary	straordinari straordinaria straordinarie» straordinari» straordinariato straordinario straordinarie straordinarietà straordinaria» 
lessons	lezioni lezione rudimenti imparate imparati imparato insegnate imparare lezione>> 
pub	pub locanda ristorante saloon inn hotel casinò birreria taverna 
paralympics	paralimpiadi olimpiadi paralimpiade paralimpici paraolimpiadi olimpiade olimpici paralimpica preolimpici 
monte	monte montecarlo monter porada fonso casino monteruzzo montesoro monterux 
maría	maría alejandría jerónima arón cángele ángela miña serón berón 
segments	segmenti segmento parasegmenti segment segmentazioni sequenze parasegmento segmentate segmentare 
deer	lupi coyote wapi cani bisonti cervo lupo orso volpe 
wireless	wireless communicazione telefonica telefonia telefoni ricetrasmittente telecomunicazione telefonino wifi 
whenever	ogniqualvolta qualvolta quando ovunque no, io, continuamente tanto, seguenza 
mysterious	misteriosa misterioso misteriosi misterious misterios mistero misteriose mysteriosa mysterioso 
consultant	consulente assistente consulenza consulenti analista consulenze supervisore supervisone manager 
fraser	fraser farquharson maclean stewart mackenzie murray mackay farquhar maclaren 
formats	formato formati datassette impostazioni versioni format videocassette supporti ldraw 
jam	jam ubetcha 고 groovin jammin madbuddy mustard/ smokers okay 
chicken	pollo maiale zuppa carne fritto chicken bistecca pizza beef 
enable	consento consenti permetter permette consente consentire permettere consentono permettono 
idol	idol popstar idoli girlband temptation talent yuna popstars idolo 
reid	mck cameron stewart andrews malcolm boyd cox mcandrews reid 
births	nascite nascità decessi nascita decessi/ nascita, nasciture gravidanze nati 
amazing	incredibili incredibile incredibad straor straord incredible superbeast incredibly stupenda 
pet	peluche gatto gattino pet topo coniglietto micio cucciolo drogattivo 
upset	arrabbiato irritata delusione sorpresa sconfitta imbarazzante arrabbiati arrabbiata batosta 
loves	ama adora loves amare innamorate amore innamoratissimo odia innamorati 
stretch	lungo backwater stopway mile freeway stop backwaters backside road 
striker	centrocampisti attaccante centrocampista centrocampo portiere difensore centrocampistaattaccante terzino calciato 
accidentally	accidentalmente inavvertitamente involontariamente inavvertita innavvertitamente inavvertito accidentally casualmente accidentale 
louisville	louisville tennessee memphis brisville orleans #louisville kentucky pittsburg baltimora 
hopkins	hopkins gilliams yale hopkin washington williams michell linson macwilliams 
eds	eds carocci laterza alii ets aavv cura trad clueb 
goddess	dea divinità divinita mitologia ishtar dèa demetra goddess afrodite 
burials	cimitero sepolture sepolti sepoltura cimiteri tumuli sepolte cimiteria seppelliti 
resumed	proseguito continuato cessato cessata ricominciato ricominciata rientrato ricominciò terminato 
satisfy	soddisfa soddisfi soddisfano soddisfanno soddisfiamo soddisfo soddisfatte soddisfino soddisfare 
notion	nozione concetto teoria idea teori teorie asserto concetti principio 
voltage	volt tensione resistore resistor cortocircuito resistori voltaggio cortocircuita impedenza 
betty	betty mary clara peggy lisa millie rita ellen ethel 
marion	marion virginia amelia malisa fredericka charleston macon monica mariona 
geology	geologia geolog mineralogia geologiche paleontologia geologica geologico geografia geochimica 
consistently	sempre frequentemente preferentemente volte ciònonostante ripetutamente costantemente soventemente spesso 
cyclone	uragano ciclone tempesta uragani uragan tempestt maremoto tifone terremoto 
export	esportazione importazione esportazioni esporta export riesportazione esporto esportatore importazioni 
lightning	lightning fulmine tornado thunderstrike lightnings thunderhawk thunder tuono thunderhead 
impressed	impressionato impressionata apprezzato elogiato ammirato elogiati impressionate lodato impressionati 
maintains	mantiene gestisce possiede mantengono fornisce mantenga dispone mantenuto vanta 
logical	logici logiche logica logico intuitive intuitivo logice logics intuitiva 
aggressive	aggressivo aggressive aggressiva aggressivi aggressivita aggressività aggressivamente aggression aggressor 
jin	jin han shi baek yi kang dong xiangji seong 
julie	claudia jenny monica barbara anna julie claire michelle isabelle 
fbi	fbi agente cia investigati investigativa agenti polizia investigativo indagine 
yankees	yankees mlb cubs sox orioles browns dodgers baseball buffalo 
ludwig	ludwig friedrich #friedrich albrecht carlfriedrich wilhelmer wilhelm georg franz 
pond	laghetto waterwood pond water laghet ruscello bathwater acqua giardino 
enlisted	arruolato arruolati coscritto arruolata arruolatosi arruola coscritti arruolate sottufficiale 
moments	momenti istanti attimi momenti» avvenimenti emozioni sensazioni accadimenti momente 
conjunction	congiunta congiunto congiuntamente utilizzata b&l io, programmata congiunte coordinata 
interim	interim provvisoria dimissione dimissionario terim provvisore sostituto provvisorio vice 
lucky	lucky fortunato unlucky bravo monello fortunati plucky leo braver 
targeted	mirato target indirizzati mirata mirati bersaglio indirizzato rivolti bersagli 
lon	lon tak winch hinh khoa tod kruger boen kuaf 
speedway	autodromo eurospeedway speedway autodrome autodromi aerautodromo raceway kartodromo corsa 
regiments	reggimenti battaglioni fanteria reggimento, leggimente reggimentali reggimento reggime reggimentale 
prevented	impedito impediti rallentato impedi causato ostacolato preveniente facilitato impedite 
toy	giocattolo giocattolino giocattolandia giocattoli giocattolone toy giocattolini giocattolaio pupazzetto 
bicycle	bicicletta bici biciclettata biciclette bike bicycle bicyclette bicicleta biket 
purely	puramente essenzialmente meramente prettamente unicamente esclusivamente bensì fini puro 
interactions	interazioni interazione interagisci interagisco interagisce interagisca interazionali interagiscono interagiscano 
fraud	frode fraudolenza frodi corruzione fraudolent fraudolenta contraffazione fraudolente accusa 
lang	lang mung rung wai mang grah tung blang longlist 
arcade	arcade videogame videogames videogioco gioco gameboy sega virtua videogamer 
sanctuary	sanctuary santuary santuario sanctuarium sanctuary〜 tempio #sanctuary aquarium acquarium 
dragons	draghi dragons dragone drago mostri dragoness dragon dragonstrike dragonslayer 
copa	copa campeon campeonato campeonati libertadores libertadora américa coppa campeones 
careful	attento attenta accurato accurata accurati scrupolosa scrupoloso accurante accurate 
nurse	infermiera infermiere infermieri medico capoinfermiera ginecologa pediatrico fermiere ostetrica 
rivals	rivali rivale arcirivali acerrimi rivalita competitori rivalità blasonati rivals 
module	modulo moduli module modul modulino modules setup modulor opzionale 
supplement	supplemento supplementi supplementa supplemente supplem supplementare supplementazione mensile supplemental 
lens	proiettore grandangolo fotocamera riflettore mirino lens focale cinescopio zoom 
patron	protettore patrono patroni patronio patrona patronata benefattore mecenate patronne 
commands	comandi comand comando commandi comando/ comando, comande comanda comandos 
trend	trend tendenza tendenze fenomeno controtendenza calo evoluzione moda ±∞ 
superintendent	ispettore sovrintendente viceispettore ispettor ufficio assistente funzionario direttore ispettoria 
gerald	gerald walter riccardo giorgio wilfredo geraldi philip josi geraldin 
rap	rap hop rapper hip gangsta crunk mixtape dj reggaeton 
geneva	ginevra ginevra, ginevrade losanna ginevra» genevra parigi zurigo convenzione 
ash	ash cenere ceneri ceneride argilla nuvole bruciare bark magmadon 
blade	spada blade corsoio gunblade tagliente affilatore fodero wakizashi xblade 
disappeared	scomparsi scomparì spariti scomparve sparito scomparso scomparsa sparì sparita 
array	array dimensione multi campionario input multicomponente campionare spettro antenna 
patrolling	pattugliare pattugliamento pattugliamenti pattugliato sorvegli pattugliando sorveglio pattugliano pattuglie 
predominantly	prevalentemente principalmente prevalenza prevalent prevalentemete prevalence perlopiù predominante predominato 
committees	comitato comitati sottocomitati commissioni sottocomitato delegazioni commissione consultive direttivi 
boom	boom kaboom straor gaspa crisi peep jump bounce boome 
sailors	marinai marina, barche rematori imbarcazioni velieri soldati equipaggi pescatori 
beaten	fermati confitto battuti sconfitto sconfitti confitti fermato picchiato frustata 
smoke	fumo smoke polvere sigaretta fuoca fuoco fumi smokes incendiary 
assassination	assassinio attentato attentata attentat attentati uccisione attentatore complotto assassination 
lancaster	lancaster chewton egton cotford hereford bedford láncaster bridgehampton chester 
reynolds	reynolds mck mckelvie richardson rdson reynold aδ mcreynolds fisher 
divorce	divorzio matrimonio divorzi matrimonia matrimoniale matrimonios matrimoniali matrimoni divorzia 
dust	polvere pioggia cenere polver pioggi dust nuvole vento nuvola 
saxon	sassone sassoni wessex sasson germanica northumbri viching germanici dietwulf 
separately	separatamente singolarmente separati rispettivo separato separate precedentemente distinte separat 
sockpuppet	sockpuppet ip sock sockpuppets vandal sockupuppet sockpuppo sockpuppett suckpuppet 
grain	grano frumento cereale grani cereali cerealia granot orzo fieno 
executives	dirigenti produttori direttori executive atori manager clienti investitori imprenditori 
translations	traduzioni traduzion traduttori tradotti tradotte traduzione testi traduttor 
zimbabwe	zimbabwe sudafrica yezimbabwe lezimbabwe kenya uganda africa namibia zimbabwean 
thrown	gettata gettato gettati buttati affogati buttato affogato buttata scagliato 
cohen	cohen freedman levy moshe levi meir aharon kaplansky yehoshua 
puts	mette restituisce risce pone tiene posiziona tira vede disce 
diving	subacqueo subacquea subacque subacquee diving immersioni nuoto subacquei kayak 
carroll	carroll lewis hatchell catherwood mccarroll warren adair russell carrolton 
accounting	contabilità macroeconomia contabile contabilita contabili microeconomia bilancio economia macroeconomica 
mesa	mesa albuquerque palomino lorado conejos camarillo canyon clarita álamos 
prussia	prussia prussiano prussi brandeburg brandeburgo germania polonia brandeburger prussiana 
intelligent	intelligente intelligenti intelligent intelligently intelligente» intelligenti» intelligentemente superintelligente intelligentissimo 
cherry	cherry ciliegi ciliegio ciliegia ciliegine limoncello lime ciliegino rose 
underlying	sottostanti elementi sottostante sottostanno dinamica intrinseci strutturale, intrinseche sottostando 
tobacco	tabacco abacco labacco sigarette tobacco marijuana alcolici piantagione tabacchi 
cleaned	ripulito rimossa rimossi ripulita ripuliti rimosse ripulite recuperata sistemata 
varieties	varietà varianti tipi cultivar varieta sottovarietà sottovarianti #varianti arianti 
bench	poggiapiede seduto sostituto giudice sedere siede bench tribunale poggiapiedi 
directions	direzioni direzione direttrici direzionali direz direzionate direziona traiettorie direzionano 
ellen	ellen helen agnes mary betty jane katherine katherin lisa 
padding	padding #eee px #eeefff background }}padding #ccc #ee #eeeeff 
measurement	misurazione misura misurare misurazioni misurante misuro misurando misure misuri 
paradise	paradiso #paradiso paradise paradisia eden paradisiaco paradisi paradisu paradisio 
alexandria	alessandria alessandria, alexandria egitto cassandria assandria constantinopolis constantinopoli alessandria» 
complement	complemento funzione as+ complementata complementi sottounità gruppoopzionale complementato ordinata 
witch	strega witch streghe witchy stregato stregatto mago streghetto sorceress 
attraction	attrazione attrazioni attrattiva attrattive attrattivo attrattività interesse attratte attrattivi 
diana	diana elena laura renata consuelita glorianna celinda justina orianna 
personalities	personalità personaggi famosi illustri artisti intrattenitori nomi celebrità influenti 
colleagues	colleghi collaboratori ricercatori amici scienziati professori compagni oncologi ettori 
busy	affollato tranquil tranquillo sorveglio impegnato shopping indaffarate trafficone indaffarato 
cia	cia kgb fbi nsa intelligence mossad controspionaggio bnd agente 
screenwriter	regista sceneggiatore cosceneggiatore sceneggiatore/regista regista/sceneggiatore cinematografico nomesceneggiatore soggettista/sceneggiatore sceneggia 
rankings	ranking graduatori rankings graduatoria graduatorie classifiche punteggi classifica graduatore 
aboriginal	aborigeno aborigena aborigeni aborigene aborigenes indigeno indigena aborigine nativi 
commanders	comandanti comandanto comandante comando comandanta comand soldati comandati ammiragli 
salem	salem carolina washington lafayette harleston carolinas avon macon nadiah 
wagner	wagner weber newmann hoffmann herfmann rosenmüller sieberer kleiber schreier 
sanctions	sanzioni provvedimenti canzioni embargo bando decisioni inasprimenti sanzione avvedimenti 
americas	americhe sudamerica asia centroamerica america africa oceania caraibi america, 
instructor	istruttore insegnante allievo abilitazione assistente allievi istruttrice aspirante insegnato 
nobility	nobiltà nobiltá nobiliare nobili casata nobilia nobiliari aristocratici aristocrazia 
divorced	divorziati divorziato divorziata sposata sposato sposati divorzia divorziate risposati 
varies	variano varia variare variar variabile differisce variava variaz variac 
tomorrow	domani futuro tomorrow tomorrows meglio, tomorrowland è/domani no, aspettami 
manuscripts	manoscritti manoscritto manoscritte manoscritta pergamene papiri bibliot papir biblioteca 
unified	unificato unificati unificata unifica unificatori unifi unificate unifico unified 
clarify	chiarire chiarificare spiegare chiarifico chiarirti capire spiegarti chiarifichi spiegalo 
scouts	scouts scout scoutman boyscout scouting scoutmaster scoutlink scoutball seals 
investigations	investigazioni indagini indagine investigazione ricerche investigati investiga investigativi indaghi 
silva	silva souza veira oliveira rodriguinho riveira adilson mendes correira 
derek	shaun derek gianluca ian nigel kevin andy fabio jeremy 
agenda	agenda politicy politica, politic complotto obbiettivo mentalize ideologia attivismo 
provision	disposizioni fornimento regolamentazione obbligo agevolazione requisto legislazione surrogazione emendamento 
humanity	umanità umanità» umani, umana humanità umanita umani inumanità umaniz 
admit	ammetter ammettere sincere ammetterla ammette ammetta ammetterle ammettete insincere 
terror	terrore terror terrori terrorio terroristico #terrore terrorismo terrorist terrore» 
contestants	concorrenti concorrente televoto televoti televoter televotati giudici reality televotata 
trinidad	trinidad giamaica bahamas tobago antille barbados cuba panamá bahama 
distant	distant lontano lontane lontana lontani distante distanti vicini lontando 
burke	burke fitzgeralds fitzgerald cole bellisle connor sullivan kennedy webster 
circles	circoli cerchio cerchie circolo vertici circle cerchi mircoli sfere 
assignment	mansione assegnamento riassegnazione assegnatale assegnar scelta dipendenze riassegna assegnazione 
recalled	inviato disse cinato omaggiato impressionato spedito prestati avutato prestato 
shrine	santuary santuario tempio shrine #santuario santuari mausoleo santuarios tomba 
sail	imbarcazione barca veliero salpa navigar nave salpare sail vela 
willie	willie sammy jerry johnny jimmy minnie frankie jhonny sam 
karnataka	kerala tamil gujarat india maharashtra rajpur maharashtri rajapur madhupur 
celebrate	celebrare festeggiare celebrar festa festeggi festeggino festeggio anniversario festeggiamenti 
ranch	ranch rancho fattoria ranchito ranchos rodeo ranche canyon ranchetto 
vampire	vampire$ vampire vampiressa vampiri vampiro vampiresca vampir vampirella vampirello 
playwright	drammaturgo commediografo scrittore poeta librettista commediografa romanziere commediografi teatrale 
sick	ammalati malati poveri pover ammalate ammalato gotta bisognosi malato 
associates	partners associates associati collaboratori inc fratelli vertici & igi 
ethiopia	etiopia kenya africa —africa uganda sudan ghana mafrica gibuti 
flags	bandiere bandiera, bandieri bandierai bandiera bandieranti bandieraio simboli sventolanti 
tel	tel aviv haifa israele israeliana israelian gerusalemme gerusalem giaffa 
learns	scopre apprende intuisce rivela apprendono conosce svela 피의 apprenderà 
shorts	shorts pantaloni cortometraggi tunes corti corto metraggi looney lungometraggi 
drives	drive drivel driver pendrive disk drives floppy driv cassette 
accomplished	eseguito eccell eseguita eccellente eccel versatile abile effettuato velocizzato 
autobiography	autobiografia autobiografie autobiografica autobiografico biografia autobiografía autobiografici libro autobiography 
recruited	reclutato reclutati reclutata reclutate arruolati arruolata assoldati arruolato ingaggiati 
uprising	insurrezione rivolta ribellione sollevazione ribellion insurrezioni insurrezionale sommossa sollevazioni 
edwin	edwin walter lionel alfredo arold wilfredo edwing arturo davide 
velocity	traietto velocita velocità traiettoria m/s^ fluido, accelerazione velocitá δv 
terminology	terminologia glossario terminologico terminologici terminologie terminologica terminologiche definizione glossari 
raiders	raiders predoni eagles aquile pirati cowboys dolphins buccaneer ravens 
coordinates	coordinate wgs coordinata m,a vettori vettoriale maricentro v,a geocoordinate 
brighton	brighton londra manchester norwich sussex farhampton liverpool roehampton coventry 
viola	viola viole violoncello violina sonat violini violino clarina pianoforte 
para	para combinado antigo próximo difícil faltas puntos pátria icas 
morrison	morrison morrisoni lorrison warren orrison mcclay mck anderson harrison 
propulsion	propulsione propulsi propulsivo propulse propulsioni propulsive propulso propulsa propulsiva 
boxer	pugile pugil lottatore pugilista boxer pugilatore pugilato pesi pugilist 
finale	episodio episodo episodio, puntata ,episodio episodio» conclusivo stagione premiere 
shoulder	schiena ginocchio polpaccio spalla ginocchia caviglia ginocchi gamba coscia 
disabled	disabili disabile disabilitato disabilitati disabilitata disabilita disabilitava disabilitante disabilitate 
div	div divisione/serie ,q vba divisione, $div divisio bdu divisione/brigata 
tactics	tattica tattiche strategia strategie karategi tattico tattici autodifesa combattimento 
ernst	ernst jungermann gustav friedrich wilhelm wilhelmer ludwig carlfriedrich georg 
innocent	innocent innocente innocenty innocentio innocenti innocentini innocenti» innocente» innocents 
rapper	rapper rap rappe mixtape rappers rappin eminem dj nesli 
privacy	privacy riservatezza sicurezza #sicurezza federprivacy sicurezza, inviolabilità incolumità privatezza 
boeing	boeing airbus aerox airliner learjet airlines aeromot aereo airbusa 
cites	cita citati citato citaz citano riferimenti citata citazione citazioni 
bunch	mucchio gruppetto checca sacco funnybot grattachecca fichetto small popò 
emmy	emmy nomination bafta premi ‘miglior miglior primetime „miglior oscar 
indo	indo indiano indoaria indoari austroasiatica austroasiatic austronesiana indoario austroasiatiche 
distinguish	distinguere distinguerli distinguerle distinguervi confondere distinguerla distingui distingueremo distinguerci 
rosa	clara rosa cortez rosana blanca rosan marìn florero fernandiz 
thermal	calore termica termico termici temperatura termiche temperature termo riscaldamento 
flute	flauto flaut violino flauti flauta oboe clarinetto contrabasso pianoforte 
marines	marines soldati marinai commando plotone fanteria marine battaglion paracadutisti 
feminist	femminista femminismo femministe femminismi femminista» femministi ecofemminismo ecofemminista femminine 
trustees	trustee trustees soci benefattori fondazione direttivo membri presidente gwmnma 
sculptures	sculture scultura statue bassorilievi dipinti scultoree sculto sculturi statuette 
bacteria	batteri microorganismi microbi microrganismi microbici microorganismo bacterium microbiotica miceti 
introduce	introdurre introdurne introdurremo introduzione introduce introdurle introdurrei introdotte introdurlo 
rivalry	rivalità rivalita rivali amicizia/rivalità gemellaggi/rivalità #rivalità arcirivali rivale tifoserie 
prevention	prevenzione prevenzioni prevenir prevenire prevenzione» profilassi preveniente prevenga preven 
honored	onorati onorata tributato premiato onorato tributati onore tributata omaggiato 
healthy	sano sani sane sana salute naturi food care vegetariana 
circus	circo circus circense colosseo giocoliere circensi #circus pantomima acrobati 
speculation	speculazioni indiscrezioni speculazione supposizione indiscrezione diceria rumors supposizioni complotto 
burma	birmania cambogia thailandia birma vietnam tailandia birman myanmar birmana 
sec	jwl floatin ˚ int canestro rbcs ncaa passaggi pac 
quiet	tranquillo tranquilla silenziosa tranquil quiete silenzioso quieta tranquill quiet 
knee	ginocchio caviglia polpaccio ginocchi gamba ginocchiato ginocchio» ginocchia ginocchiata 
deliver	consegna consegno ricever consegnar inviar invia uno, me, consegnare 
hypothesis	ipotesi teoria #ipotesi teorie hypotesis teori evidenze ipotizza tesi 
referendum	referendum #referendum plebiscito plebiscita 중구 votò abrogazione emendamento assemblea 
travelling	viagg viaggiar viaggiato viaggiare viaggia viaggiando viaggio viaggiari viaggi 
estonian	estone estoni finlandese finlandesi tedesco/finlandese estonia estonia, eston estonian 
pastor	pastore parroco predicatore viceparroco evangelico evangelica prete cristo, evangelo 
sofia	sofia delgrado mosca plovdiv stoccolma belgrado istanbul levski fajti 
tribune	quotidiano tribune» corriere tribune giornale messaggero times daily gratidiano 
lasting	duraturo durata duraturi duratura durature durato durati protratto durat 
permit	permessi permessa permesso consenti consentir permesse consentiti consentire divieto 
priority	priorità priorita priority prioritario prioritaria prioritari opzione urgente vulnerabilità 
pounds	libbre chilogrammi pounds chilogrammo chili tonnellata grammi kg quintale 
cent	cent percento % dollaro percent tasso percentile ammontante miliardo 
consequence	conseguenza risultato conseguenza» conseguentemente consequenza condizione causa poiché ¬φ 
rica	rica messico venezuela ecuador colombia guatemala honduras nicaragua dominicana 
furniture	arredamento arredamenti arreda mobilio mobilia sedie arredi stoviglie tappezzerie 
macdonald	macdonald macler maclean macdougall stewart macdonogh macdougal macdonell macdonalds 
honest	onest onesto no, buono sincero bugiardo sincere sagace borioso 
innovative	innovative innovativi innovativo innovativer innovazione innovativa innovati innovazioni innovata 
estimate	stime stimare stima stimato stimati stimata stimarne stimano stimate 
atp	atp datp doppio singolare oatp circuito biosintetico bcr garros 
rotation	rotazione rotazioni rotazionale #rotazione rotazionali rotato malrotazione rotazionalmente precessione 
syracuse	syracusa syracusæ philadelfia utica siracuse siracusa syracuse philadelphia rimini 
lecturer	professore docente insegnante laureato università visiting professore#professore emerito postdottorato 
automated	automatizzata automatizzato automatizzati automatici automatizzazione automatica automatizza automatizzabile automate 
obscure	sconosciuti chiara semisconosciuto misconosciuti semisconosciuti sconosciuto chiari sconosciutissimo misconosciuto 
kosovo	kosovo serbia bosnia albania erzegovina #kosovo croazia jugoslavia bosnia/erzegovina 
classics	classici classica classics classica, classics, classic/rai classics/emi classicks classico 
julius	julius ulius augusto felix cecilius adolph iulius ulpius giulio 
appreciated	apprezzato apprezzati apprezzami apprezzar grati elogiati benvenuto graditi grazie 
naples	napoli napoli, sicilia roma palermo napolis messina salerno amalfi 
sebastian	sebastian sebasti #sebastian sebastiao sébastian sebastien sebastianello sebastia sebastiàn 
activated	disattivata attivato attivata attivati deattivato disattivati disattivato inattivata disattivate 
varied	varia variato differenti variata variano variati variegato vario variar 
offense	offensività infrazione offensivo commetta offense reo provocazione offensivista sanzione 
barnes	barnes lecompton sharpe wright fingleton ingleton derwood thorner garnes 
acknowledged	riconosciuto riconosciuti riconosciuti» riconosciutone affermato riconosciuta riconosciutosi riconosciutole riconosciutagli 
exceptions	eccezioni eccezione casi tranne limitazioni quelli obbligatori norma deroghe 
martha	martha evelina francesca elena laura carol ellen diana alda 
quarters	alloggi alloggio stanze appartamenti stanza dormitori dormitorio mews room 
drawings	disegni schizzi illustrazioni litografie fotografie bozzetti acquerello acquerelli disegno 
hitting	colpendo rimbalzando colpire colpisci rimbalzo colpendolo colpendola colpendone colpendogli 
refuge	rifugio refuge riparo protezione everglades rifugiare sanctuary wildlife wilderness 
maharashtra	bhatnagar tamil gujarat rajapur durgapur kerala dapur india krishnagar 
conventions	convenzioni convenzione regole internazioni convenzionalità norme schemi ferree clausole 
elliott	malcolm strollo edwards southerly stewart miller watkin wilson brett 
diplomat	diplomatico ambasciatore ambascia ambasciator ambasciata diplomatista ambasciadore #ambasciatore funzionario 
unused	inutilizzato inutilizzabile inutilizzata inutilizzo inutilizzati vuota vuotato inutilizzabili utilizzabile 
searches	ricerca ricerche indizi google scova rintracciare scovare prove riscontri 
brigadier	colonnello tenente brigadiere generale brigadier comandante sergente brigadieri caporale 
particle	particella particelli particella, particelle particellare quasiparticella quantica particellari sparticella 
malayalam	hindi telugu tamil malayalam gujarati urdu bengali punjabi kannada 
thursday	sabato venerdì giovedì lunedì mattina domenica mercoledì venerdi martedì 
icon	icona icone icon icon» simbol stylo iconos iconetta icons 
ulster	ulster irlandesi leinster irlanda dublino cork irlandese irish connacht 
genes	geni cromosomiale gene dna cromosoma genoma cromosomi genomi cromosomici 
infinite	infinita infinitor infiniti infinite infinità infinito infinitas infinitors infiniti» 
considerably	notevolmente considerevolmente sensibilmente leggermente significativamente enormemente molto ulteriormente notevolemente 
vale	egton severn neath cardiff fenchurch farhampton bridgehampton dunchurch carhampton 
portraits	ritratti ritratto ritratte dipinti ritrattisti autoritratti autoritratto ritrattini portrait 
paste	sfogliatura sfoglia sfoglio sfogli vaniglio incollatura incollando impasto sfoglie 
randy	randy rick bobby steve tommy matt jerry chuck eddie 
saxony	sassonia germania baviera brandeburgo prussia brandeburg königsbach ansbach baviera, 
convoy	convoglio scorta salpato salpate motosilurante navi salpò nave scortare 
annie	cathy annie maggie julie millie rachel lisa deannie rita 
excessive	eccessivo eccessiva eccesso eccessive eccessivi eccessività eccessiva» eccessi eccessivo» 
believing	credendo credere crede creder credeva convinti convinto convinta convinci 
rhine	reno reckingen tannheim breisach gingen alsazia beröringen recken göggingen 
mineral	minerali minerali, minerale idrominerale mineralogo mineralità minera idrominerali minerari 
implement	implementare implemento implementi implementazione implementa implementino implementarli implementata implementato 
surgeon	chirurgo medico chirurg ginecologo oculista neurochirurgo urologo chirurga cardiochirurgo 
badge	badge distintivo insegne stemma vessillo nastrino emblema ufficiale spalling 
charleston	charleston harleston carolina savannah hampton macon vicksburg carolinas charlestown 
clause	clausola clausole clauso vincolo lodo nullità statuizione deroga emendamento 
infection	infezione infezioni virus malattia contagio infettiva morbillo gonococco febbre 
electron	protone elettrone elettroni selettrone bettrone elettron fotone protoni elettrone, 
walt	walt disney disney» topolino warner pinocchio disney–abc pollicino paperino 
cnn	cnn news sinews rainews dnews allnews tgcom cnbc espn 
likewise	seguenza seguentemente invece similmente io, quindi e poiché analogamente 
tonight	tonight night serata stasera gotta notte buonanotte show bonanotte 
confederation	confederazione confederazioni federaz #confederazione konfederak federazione ederazione confederation confedera 
casino	casinò casino hotel resort azzardo casinos vegas #vegas albergo 
doctorate	dottorato laurea dottora lauree laureato addottorato postdottorato honoris bachelor 
aux	aux cueurs moins meurs deurs dédale lueurs flamants yeux 
guatemala	guatemala messico honduras colombia ecuador messico, guatemalan bolivia nicaragua 
settings	impostazioni opzioni modalità cartelle ambienti impostando impostabili settaggi >opzioni 
mask	maschera mask mascheraio guanto mascherato maschere maschera» mascherarsi face 
shelter	riparo ricovero alloggio rifugio asilo shelter ricoveri shelta assistenza 
dorothy	dorothy mary margaret peggy poppins adelinda edith lillian beatrice 
ethnicity	etnia etnico etnicità etnici etnica etnie etniche nazionalità etnicamente 
hopefully	sperando suggerimenti affrettatevi aspettatevi presto, xfavore spero ☮ prometto 
elimination	eliminazione #eliminazione eliminazioni eliminaz autoeliminazione elimination eliminatorî eliminatoria riduzione 
heath	brughiera heath brughi hill winwick clapham hanbury schiltern goldington 
pregnant	incinta gravidanza incinto parto incinti gravida incinte malata genita 
richards	richards morgan rogerson wilson taylor clark evans mck stevens 
theodore	theodore theodoro oreste costantino alexandrea teodoro theodori irene giuseppe 
delegates	delegati rappresentanti assemblea elettori superdelegati assemblee congressisti rappresentanza eletti 
blair	blair ramsay selfridge bellwood campbell paynter graham winstone thatcher 
fac	vetrinazione vaglio vetrinam vetrina vdq vetrinazioni devetrinazione revisone fase 
phrases	frasi parole locuzioni espressioni vocaboli pronomi frase parole, coverbi 
preference	preferenza preferenze preferente preferentemente preferei prefer preferendone preferibilità preferenziale 
janeiro	janeiro brasilia rio brasile brasili brasilândia petrópolis maneiro bahia 
concerto	sinfonia sonata sonat sonate violino sinfoni sonatina violoncello sonaten 
bits	bit chunk sottosequenze input buffer grezzi fetch sottochiave frame 
construct	costruire costruir costruirci costrui costruzione costruii costruisci costruire» costruiremo 
tune	melodia canzone ritornello canzon sottofondo ballata tune ninna song 
unofficial	ufficiale ufficiale, ufficiale/ufficiale ufficial semiufficiale ufficiale/ ufficioso uffic ufficialita 
lighthouse	faro lighthouse molo lighthouses isola spiaggia promontorium promontorio scoglio 
stan	stan bart monica jack bill andy alex nathan hank 
highland	highland highlands highlanders montagna highlander inverness kilt glenmore scozzese 
mascot	mascotte mascott mascotto logo emblema mascot soprannome mascota simbolo 
squadrons	squadroni squadriglie squadriglieri squadron squadrons squadrone squadriglia quadriglie bombardieri 
acceptance	accettazione accettatto riconoscimento adesione pienamento accettazioni apprezzamento approvazione ampiamento 
tight	tight delicate stretch strette corto cavigliasso strettle 하는 rigged 
considers	considera reputa afferma dichiara definisce dimostra ritiene sostiene considerano 
hub	hub snodo terminal connect centro fulcro collegamento cityjet centerport 
routine	routine routines eseguire eseguirsi coroutine routinario eseguendo programma routinari 
dubbed	chiamato conosciuto soprannominato soprannominata denominato ribattezzato ridoppiato soprannominati rinominato 
dozens	dozzine decine centinaia migliaia centinaio decin dozzina moltissimi numerosi 
spotted	avvistato avvistati avvistata notata avvista avvistate avvistare avvistava avvistano 
harmony	armonia armonio armony armonie armonica armonia» armonia/la armonium armonicità 
entrepreneur	imprenditore imprenditrice tecnologo magnate prenditore multimiliardario filantropo imprenditrici multimilionario 
wwe	wwe ecw wwf kayfabe smackdown raw wrestling smackdownǃ wrestlng 
apollo	apollo afrodite ares athena hera hercules venere artemide mercurio 
naked	nudo nudi nuda nude naked seminuda nudino pornograffiti nudità 
anton	anton georg josef valentin filipp markevich vincenz alois kostantin 
moses	mosè tobiah abramo mosè» moses eliah giah giacobbe pirker 
legally	legalmente ufficialmente illegalmente maggiorenni giuridicamente regalmente maggiorenne formalmente violabile 
fake	falsi fasulli falso fasulla falsified fasullo fake false fasulle 
revolt	ribellione rivolta ribellion insurrezione sollevazione ribellioni insurrezioni ribellione» ribelli 
equity	equity investimento capitalize capitalia investment liquidità capitalizzazione investitore reinvestment 
providence	boston providence princetown philadelphia island baltimora raleigh philadelfia haven 
investors	investitori investimenti investimento capitalize investitore azionisti capitalia economi capitali 
reliability	affidabilità inaffidabilità affidabilita affidabili attendibilità guidabilità contendibilità vendibilità manutenibilità 
tenor	tenore baritono soprano contralto tenori baritona tenor baritonale tromba 
fights	combatti combatte combattimenti combatter combatta lotta combattimento battaglie combattutto 
pocket	pocket pocket» tasca pocker pock taschetto portatile pocketpc sacca 
sad	sad noći noć triste ljubi dizdarevic sognar bistro ljubvi 
troy	troy damone nasso nicone damos pitteo fione arianna troia 
treasure	tesoro tesori tesor treasure tesoros scrigno tesoro» tesoromio forziere 
ion	ion ione ioni ionici f− litio mercurio ionone ionica 
rendered	resi reso resa pronunciato renderizzata renderizzato eseguita pronunciata rach 
transformed	trasformato trasformata ritrasformato ritrasformata trasformatosi trasformati trasformatasi ritrasformati ritrasformate 
roberto	carlos roberto jancarlos fernando josé alberto barlos mario josè 
adoption	adozione adozioni riadozione #adozione adottare legalizzazione adottabilità adottata standardizzazione 
decrease	aumento diminuzione riduzione incremento diminuire decremento aumentata diminuisca aumentare 
reserved	riservato riservata riservati riserva, riservate esclusivo esteso limitato riserva» 
forgotten	dimenticati dimenticata dimenticato forgotten dimenticate perduto scomparso perduti scomparsi 
lok	lok sidhi chhin chhu budh bhang panchang bhai bhi 
crop	grano coltura coltivazione coltivar frumento cereali agricoltura patata granoturco 
licensing	licenze licenza autorizzazione copyright autorizzazioni copyrigh regolamentazione autore/copyright pubblicità 
collecting	raccogliere raccogliendo raccogli raccolta raccola raccolto raccogliendoli collezionare raccolti 
treasury	tesoro tesoreria tesor tesoros tesorerie tesoro» banca finanze monetario 
trumpet	tromba contrabbasso contrabbassi flauto fiati clarinetto percussio pianoforte trombone 
johnston	johnston pearson farquharson eaton mackworth macdonald reid maclean ackworth 
uncertain	incerto incerta incerte incerti probabile ignota sconosciuta esatta probabilm 
norton	norton cracco chewton oler chirbury seabury pulino starbury arold 
collector	collezionista collector collezionatore collezione rilegatore mercante pesatore legatore raccoglitore 
cluster	cluster grappolo stelle clustered addensamento glom tau ɵ globulari 
dear	caro amico, carissima dio, dear carissimo no, sincerely amatemi 
georges	georges pierre lefrançois mondière jean françois clémentin claude camille 
roller	roller wakeboard rolley pattini rollerblade coaster rollerball kickball breadboard 
clothes	vestiti indumenti abiti scarpe biancheria abbigliamento abbigliamenti vestiario vestito 
sovereign	sovranità sovrana sovrane monarca sovran sovrani sovranita regnante nominalmente 
enhanced	potenziato potenziata migliorato migliorata migliorate potenziati potenziate migliorati enhanced 
compensation	indennità indennizzo risarcimento compensazione versamento risarcimenti indennizzi restituzione compenso 
consent	autorizzazione assenso decisione approvazione diritto atto diritti promissione permissione 
outline	dettaglia dettagliata descrizione glossario dettagliato abbozza appunti dettagliante #presentazione 
jorge	jorge miguel josé pedro carlos baqueiro serón valerón beto 
darkness	oscurità tenebre darkness tenebra oscurità» darklight ombre oscurita buio 
penalties	penalità inflitti penalita rigore penalti penalty inflitto penalizzi reati 
bombers	bombardieri bombardiers caccia/bombardieri cacciabombardieri aerei bombardieri/aerosiluranti bombardiera bombardiere bombardi 
holes	buchi hole buco buche pettine massi holes modini fessure 
blow	colpisci colpo シュート fly sferra pugno chook mano, bother 
cooking	cucina cucinare cucin culina cucinarsi culinare culinario cucinando cuoche 
aftermath	disastro catastrofe catastrofica crisi disfatta disastrosa catastrofe» avvenimenti catastrofico 
trainer	addestratore trainer istruttore acrobatico lottatore allevatore idroaddestratore acrobatica addestramento 
measuring	misurante misurare misuranti misurando misurazione misura misurano misurarne misuro 
chip	chip microchip microchips chips microprocessore processore card ram vram 
consciousness	coscienza mente coscienze coscienza» percezione coscience autocoscienza subconscio inconscio 
archaeology	archeologia etnoarcheologia geoarcheologia xenoarcheologia l´archeologia bioarcheologia esoarcheologia fantarcheologia archeologica 
latvia	estonia lituania lettonia finlandia estonia, bielorussia polonia belinlandia croazia 
telugu	telugu hindi tamil malayalam punjabi bhi kannada bhati gujarati 
blogs	blog siti web blog/ gossip blog» weblog giornali internet 
protecting	proteggere protezione proteggendo protegger protegge proteggre proteggente proteggerne proteggendone 
hardy	hardy porter campion manthorpe taylor abel lister blake ambrose 
nicknamed	soprannominato soprannominata soprannominatosi soprannominati soprannomina soprannominate soprannome soprannominò soprannominava 
scorer	gol capocannonieri assist capocannoniere goal capocanniere realizzatore capocannonniere segnate 
stamp	francobollo francobolli banconota moneta banconote commemorativo cartolina commemorativa stamp 
nat	nat mem bsp acc soc ram tamarit nerio comp 
fur	pellicce pelliccetta pelliccie pelli pelliccia pellicciaio pellicci lana pellicciai 
redirected	redirectato cancellato rediretto redirect spostata reindirizzato spostato disambigua eliminato 
estimates	stime stimati stimano stimato stimate stimata stimò stima stimac 
lit	letteralmente עץ lett hei lumin luming yit illuminaten במדבר 
ritual	rituale rituali riti ritual ritualità rito sacrificale cerimoniale ritualmente 
locality	località vicino sobborgo localizzato natangi situtato periferia vicinanze zona 
trace	traccia fll ufll tracce radici impronte i& viva tracciante 
marble	marmo granito marmi alabastro pietra porfido statue scolpito calcare 
foundations	fondazioni fondamenta fondamenti fondazionali strutture fondazionale basi fondazione fondaz 
politically	politicamente ideologicamente politicante socialmente politic politicy culturalmente politica, geopoliticamente 
nottingham	nottingham manchester leicester birmingham ranchester notthingham dunchester granchester lanchester 
derivative	derivata derivativa derivativo derivativi derivate derivative derivatale derivato derivati 
boxers	pugili lottatori pesisti atleti pesi pugilatori pugil pugi pugilati 
dimension	dimensione dimensionale dimensionalità dimensionali spazio codimensione cubo dimensionando superdimensionale 
crawford	stewart crawford carter clark pagett warren vaughton russell cooper 
bats	pipistrelli mosche pipistrellorchi scarafaggi volanti gatti conigli chirotteri pipistrello 
yugoslav	iugoslavo jugoslavi jugoslava jugoslavo jugoslav jugoslavo» jugoslaviji jugoslavija montenegrini 
tanzania	tanzania kenya uganda malawi —africa africa mozambia zimbabwe namibia 
motto	motto slogan no, gloria, vessillo virtute uno, coraggio 力 
concentrated	concentrato concentrata concentrati concentrate deconcentrato concentro concentrando concentratosi concentrante 
dirty	sporca sporchi dirty sporche sporcano feccia sporco sexy sporcando 
hayes	hayes foster chandler wilson pitterson cluney mck teston murphy 
xbox	xbox playstation psp wii dreamcast gamecube nintendo videogame gameplayer 
identifying	identificazione identificare identificarne individuazione individuare identificando identifico identificante #individuazione 
likes	adora heartful preferiti ama ~heartful ambitious frosty gets ghoulies 
genres	generi stili sottogeneri genere sottogenere commistioni contaminazioni musicali influenze 
galleries	gallerie musei mostre galleria collezioni ,galleria fotogalleria esposizioni galleries 
forbes	forbes forbesi forbes% miliardari miliardaria munro forbesii gq alexa 
adequate	adeguato adeguata adeguate insufficiente adeguati sufficienti necessari sufficiente necessaria 
brass	tamburi ottoni percussione percussio drumsticks fiato campane campanelli metallo 
bach	bach passacaglia pachelbel schumann schubert bwv orgelbüchlein sebastian schuberti 
alias	alias eename pseudonimo bandiera nomecognome flag pseudonimi posse anagramma 
inland	entroterra costa costieri costiere costiero coste mare costiera terraferma 
wore	indossato indossata indossai indossava indossati indossar indossavano indossavo indossate 
tough	duro duri coraggioso tenace dure rude coraggiosa tough untuoso 
advertisement	pubblicitaria pubblicitario pubblicità pubblicita pubblicitá spot pubblicitariamente pubblicitari #pubblicità 
protagonist	protagonista protagonisti impersona protagonist protagonista/i personaggio narrante narratore protagonista, 
trails	percorsi sentieri trekking escursioni sentiero trekkin itinerari percorri piste 
demanded	richiesto acconsentito rifiutato chiesero rifiutati reclamato chiesto richiesero esigette 
claire	claire michelle francesca monica lisa mona sarah olivia maggie 
mistakes	errori errore sbagli difetti sviste mancanze incorrettezze correttezze inesperienza 
bruno	macher bruno juliano muraca alberto ciro fernardo léo murace 
dylan	dylan bob mick waits liam rory dylann sam dylandy 
bag	sacchetto valigia bag valigetta barattolo valigette busta pacco bidone 
churchill	churchill churchills winston roosevelt roosevelti winstone mussolini buckingham marlborough 
tan	tan lieh bai chong yuang yiu sheng suan hsiu 
climb	scalata salita scalate scalato climb arrampica arrampicate salite arrampicato 
witnesses	testimoni testimone interrogatori prove geova testimonino confessione interrogatorio #testimoni 
storyline	storyline storylines trama saga narrativo sottotrama maxisaga puntata rinarrazione 
thames	thames tamigi thame londra tyne thamesford mersey thamesmead ironbridge 
anybody	chiunque fare/non qualcuno @il nessuno chi cosa qualunqe me/non 
kazakhstan	kazakistan kirghizistan uzbekistan tagikistan kazakhistan turkmenistan azerbaigian russia turkmenia 
bots	bot disattivi temponi automatix disattivo mediawiki biobot awiki cubot 
highlights	salienti mostra volti straor novità momenti anteprime dettagli performance 
jumping	jumping salti arrampica arrampicando salto arrampicare arrampichi arrampico acrobazie 
prof	prof professor professoren professore dott professoroni professore#professore studioso professorem 
slovak	slovacco slovacchi slovacca ungherese ungheresi slovacche cechi slovaca serbo 
skull	cranio teschio scheletro ossa cranis mascella saurus skull cranico 
missionaries	missionari missionario missionarii missionaria missionarie evangelizzati evangelizzatori gesuiti missionariato 
hoped	sperava sperato speraw voluto speranza potuto speravano incoraggiato pianificato 
myth	mito leggenda mitologia leggende mitolo mitologema miti mitologemi mitologica 
mandatory	obbligatorio obbligatori obbligatoria obbligatorie nobbligatori obligatorio obligatoria obbligo obbligatorieta 
stern	prora schneider stern frenkel derfflinger poppa brandel proraso prua 
fees	pagamento pagamenti tasse tariffe imposte pagare rimborso tassa voucher 
bet	bet money giv scommessa pay dashur job sheba yoss 
monks	monaci monaster monasteri monastero monastery monasteria monastic monasterij monac 
dancers	ballerini danzatori danzatrici coreografi ballerine danza danzati danzate danzata 
quantity	quantità valore quantitativo quantita quantitá quantitativi μs prezzo misura 
inventor	inventore invenzione inventato inventor brevetta inventori inventata brevettato invenzio 
cairo	cairo egitto istanbul egiziano damasco egiziana baghdad khartoum beirut 
graves	cimitero tombe cimiteri tomba sepolti sepolture sepoltura cimiteria sepolte 
proximity	vicinanza vicino collegamento vicinante connessioni connessione vicinanti localizzatore prossimità 
seemingly	apparentemente apparenza imprevedibilmente apparent apparenze incredibilmente realtà sconosce totalmente 
sue	barbara carol loretta linda peggy diane jenny susan joanne 
armament	armamento cannoni armament armamenti cannone armamentario antiaerei antiaereo armamentari 
barrier	barriera barriere barrier barriers tunnel funnel #barriera semibarriere tunneling 
creatures	creature mostri #creature mostruose bestie creatures mostruosi creaturine ghouls 
logan	logan grayson clark carlie crook mahone rossmore mitchell warren 
erik	erik sven lars lennart larsén klarström fridrik jorik jaakke 
leicester	leicester manchester nottingham newcastle hereford ipswich cardiff doncaster bicester 
silence	silenzio silence non+silenzio silenzio» silenzi #silenzio urlo silenzio/via silencer 
jessica	jessica christina megan jessi francesca jennifer lisa kristin laura 
plateau	montagne plateau montagna montuosa altopiano flateau montagnon monti montagno 
finite	algebrica algebrico teorema algebra algebris equazionale abeliana commutativa commutativo 
precedent	decisione criterio decisioni consenso consuetudine consuetudini eccezioni ammissibilità regole 
walsh	farren donnell manning connor dermot foley farrell donagh flynn 
zones	zone aree zona regioni ecoregioni sottoregioni tipologie climiti fasi 
intensity	intensità intensità» intensita intensity w/m μs luminosità intensione intensi 
exterior	interni tetto rivestimento interno esterno interior spazioso finiture edificio 
murders	omicidi omicidio assassinio delitti omicido delitto omicidî omicidi» assassinii 
paragraphs	paragrafi citazioni righe sezioni frasi paragrafino paragr paragrafo capoversi 
costume	costume costumi indossai vestito costumino costuming maschera costum trucco 
bike	bicicletta bici bike biciclettata motocicletta pedala bikes bikey ciclette 
neighborhoods	quartieri quartiere sobborghi #quartieri →quartieri #quartiere interquartiere quartierino sottoquartiere 
imprisonment	carcere reclusione prigione condannato detenzione carcerazione condanna ergastolo incarcerazione 
suffolk	sussex essex somerset norfolk middleham suffolk warwickshire gloucestershire worcestershire 
forwards	calcianti centrocampisti destri forward palla centrocampo terzini attaccanti forwards 
remarkable	eccezionale straor straord eccell sorprendente incredibile impressionante impressionanti notevole 
differ	differiscono differisce differiscano differire differisca differente differenti differenziano differeza 
tin	ferro tin rame yiu cuo ferro, piombo latta pao 
garcia	garcia rodriguez garcias carlos garciarena sanchez miguez josè munoz 
madagascar	madagascar madagascan madagascarensis madagascarophis wildmadagascar africa madagascarinus madagascarica mauritius 
cameras	videocamere videocamera telecamere fotocamera fotocamere telecamera schermi telemetri fotografiche 
ammunition	munizioni armi fucili munizione proiettili granate fucile submunizioni munizionamento 
fires	fuoco incendi fuoco, incendio fuoca incendia incendii fiamme fuoc 
viewing	visione visuale visualizzazione interattivo visualità interattività visuali visualizer visualizzando 
explore	esplorare esplora esplorando esplorazione esplorano esplorarne esplori esplorarli esplorarlo 
builder	costruttore costrui progettista costruí architetto costruito costrutta costruita costruità 
minneapolis	minneapolis chicago milwaukee tulsa minnesota chicago, angeles/minneapolis kansas dallas 
bullet	proiettile pistola pallottola pallottolo colpo fucile pallottole colpi coltello 
kerry	kerry faly offaly connor duffy brady conor brien byrn 
subway	metropolitana metrò marciapiede #metropolitana fermata stazioni chinatown stazione fermate 
arrow	freccia arrow frecce frecc freccetta spada frecciata freccia, freccie 
economist	economista economist economisti teonomista economi economiste farmaconomista comista macroeconomia 
bread	pane carne farina matzah biscotti minestra cuoci focacci zuppa 
lou	lou teddy nini jerry porgy bob tommy dan betty 
strategies	strategie strategia metodologie metodi finalizzazioni strategien mirate fasi prospettive 
rubber	gomma caucciù nylon cotone plastica gommapiuma silicone gommaflex cuoio 
precise	accurato esatta precisi precisa preciso accurati precise esatti precisone 
rifles	fucili carabine fucile pistole rifle armi revolver karabine moschetto 
cognitive	cognitivo cognitivi cognitiva cognitive cognitività metacognitivi neurocognitivo neurocognitivi neurocognitiva 
governorate	governatorato governatorati governatorale #rinviagovernatorato shush iznatoraf shusha shushtar qahal 
nest	nido nidi cova nest uova covata nidia pulcini tane 
slam	slam doppio singolare open singolar masters battuta tornei singolarista 
portsmouth	portsmouth southampton carhampton ipswich liverpool bridgehampton plattsmouth cotford newcastle 
convince	convincere convincer persuade persuader convince convinca convincerle chiede persuaded 
boarding	scuola asilo scuole scuola, doposcuola istruzione alloggio school imbarco 
bonds	legame obbligazioni legami bonds debito ligazione eurobbligazioni legandi covalenza 
joshua	mosè joshua samuele samuel davide jacopo jacob matteo joshuah 
inhabited	abitata popolata popolato abitate colonizzato colonizzata popolati inabitata disabitata 
casey	casey zach ryan cassidy jake murphy goldi carter mccully 
attract	attrarre attirano attirare attirar attira attire attrae attiri attragga 
kilometres	chilometri kilometri km kilometre chilometro kilometro chilometrici kilometres chilometrico 
pump	pompare pompa pompante pompato pompata pompain idrovalvola pompano pompando 
feeding	nutrirsi nutrimento cibo alimentazione dieta cibando predazione suzione alimentarsi 
prey	prede predatori predatore predani predatorio predas predazione predare preda 
ain	ain sure wad te… mouz tell ardo jaballah diglio 
mathematician	matematico matema matemale matematici matematica astronomo matematice matem matematico» 
diary	diario diari taccuino autobiografia memorie diario» diarist diary resoconto 
vulnerable	vulnerabile vulnerabili vulnerata vulnera vulnerable vulnerabile» vulnerante vulnerabili» vulneranti 
inscription	iscrizione stele epitaffio epigrafe iscrizioni lapide inscrizione cartiglio cippo 
dubai	dubai doha dhabi bahrain qatar abu emirates manama marrakech 
michelle	michelle francesca melissa nicole natalie lisa leanna daniella jillian 
lebanese	libanese libanesi siriana siriano siriani palestinese egiziana egiziano libano 
productive	proficuo improduttivo improduttiva produttivo attivi proficua opero attivo contribui 
guided	autoguidato autoguidati autoguidate radioguidato radioguidati radioguidate autoguida guidato radioguidata 
happening	accadere accadendo accaduta accadono cosa eventi accaduto accadute accada 
researcher	ricercatore ricercatrice scienziato scienziata neuroscienziato studioso ricercatori neuroscienziata neuroscienziati 
baden	baden donaueschingen reno baviera saffenburg rheinfelden fürstenstein vogelsberg rumpenheim 
demonstration	dimostrazioni dimostrazione simulazione programma contromanifestazione manifestazione sperimento esercitazione esibizione 
equality	uguaglianza uguaglianza» uguaglia uguagli eguaglianza uguaglianze disuguaglianza libertà uguagliano 
philosophers	filosofi pensatori filosofi» filosofe teologi scrittori filosof platonisti sofisti 
trap	trappola trap #trappola intrappola cattura trappole intrappolare backdrop intrappolano 
clara	clara alma rita paula barbara frederica dolores cecilia bonita 
invitation	invito invitato inviti invitata invitati invitation inviting invitate invitai 
marking	marcare segnado marcatura marcati segnante segno segnazione passaggio targatura 
expertise	conoscenze competenze consulenza esperto competenza esperti consulenze esperta opportunità 
admission	ammissione ingresso ammissioni riammissione esame apertura diploma ammisione abilitazione 
sacramento	california california, francisco albuquerque sacramento fresno angeles spokane los 
certification	certificazione certificato certificata certifico certificazioni certificati certificativo certificatori certificatore 
precisely	esattamente precisamente esatti ¬φ esatta esatto ⊨ precisamente, δy 
casting	casting cast lavorazione makeup provino interpretare rilavorazione ⁱ recitazione 
reassessed	valutati ω− cron dalla classificati rimossi aug argon #dalla 
submarines	sottomarini sommergibili/sottomarini sommergibili sottomarino minisottomarini antisottomarini navi antisottomarine sommergibile 
prohibited	vietato vietati vietata proibi divieto proibito vietate proibisco proibiva 
supposedly	presumibilmente ed presunto ,probabilmente she originalmente doned lonna probabilmente 
governance	governance egovernance amministrazione oeconomia leadership istituzioni decisioni economia riforme 
frog	frog pipistrello elefante rospo coniglio crabbit bufo ranocchi criceto 
vague	vaghe vago ambigua fuorviante ambiguo guazzabuglio vaghi imprecise imprecisamente 
mhz	mhz frequenze khz ghz vhz /hz vhf thz frequenz 
secular	religiosi religios religioso secolaristi laici religiosi» secolare religiosam islamici 
tracking	monitoraggio rilevamento gps rilevazione monitorare tracking monitora monitorando quickscat 
spa	termale bagni casino termali hotel termal spa miramare resort 
publicity	pubblicità mediatica mediatico pubblicizzazione foto propagandist pubblicitaria #pubblicità publicità 
armoured	corazzato corazzati autoblinda autoblindata autoblindate autoblindo blindati autoblindi armoured 
watts	watt potenza kilowatt mowatt kilowatts kwatt aδ chilowatt amper 
gibraltar	gibilterra malta gibilterrini gibilterrine minorca spagna, gibilterrina gibilterrino spagna 
renewed	rinnovato rinnovata rinnovatogli rinnovati rinnovatasi rinnovo rinnovatosi cessata rinnovar 
reflects	riflette rispecchia rispecchio rispecchino rispecchi rifletta riflettono rifletteva rifletti 
fever	febbre gotta febbra febbri morbo malattia morbillo malaria contagiosa 
melody	melodia melodias melodie melodi ritornello canzon melody melodia» strofa 
supporter	sostenitore sostenitrice sostenitori sostenitrici oppositore fautore finanziatore sostenuto fervente 
elaborate	sontuoso dettaglia sfarzose elaborate sontuosi sontuose fastoso semplice fretting 
jeffrey	jeffrey kenneth alan steven walter robert leo melissa daniele 
discusses	illustra analizza riguardante descrive spiega estrapolato afferma sofferma tematizza 
surnames	cognomi cognome toponimici nomi toponimi toponimico prenomi patronimici etimologi 
useless	inutile inutilizzabile inutil superfluo inutili servibile inservibile inefficace superflua 
swift	swift powless barlowe whirlwind visone forward sharpest meek sharp 
tuesday	sabato venerdì lunedì giovedì martedì venerdi mercoledì mattina domenica 
silly	stupidino stupido ridicoli sciocco divertente burlona stupid stupidi stupido» 
empress	imperatrice imperatrix imperatrici imperatrice» imperatore imperatritsa zarina imperatriz ǎ 
newman	newman thorner newmann tullock langton horner lewis gordon hatchell 
scales	scala scale aδ parametriche mesoscala discala variabili centimetriche intervalli 
beatles	beatles beatles» beatlesiana beatlesiani beatle beatlesiano lennon mccartney nirvana 
clergy	clero cattolici ecclesiasti sacerdoti anglicani chierici vescovi preti prelati 
jacksonville	miami orleans atlanta jacksonville florida tampa carolina houston memphis 
sara	sara elena laura nina nadia rebecca lisa linda samantha 
lifestyle	vivere vita lifestyle moda abitudini intrattenimento lusso shopping quotidiana 
bee	bee man·ga ape farfallina gatta rainbow/ falena canarino somare 
holders	possessori titolari detenere detenendo detengono concedenti concessi detentori diritto 
baltic	baltico baltica baltici baltic balticus baltiche scandinavia estonia baltin 
czechoslovakia	cecoslovacchia cecoslovacchia（ cecoslovacchi cecoslovacchiagermania polonia cecoslovacche slovacchia cecoslovacca slovacchi 
brandon	brandon jason josh eric chad ricky diego derek kyle 
loaded	caricati caricato caricata caricate caricat caricante scaricato trasportabile caricava 
maya	maya kamaya azteco mayapan samaya mayao sume xochiquetzal olmeche 
evangelical	evangelica evangelico evangelici luterana cristiana protestante evangel cristiano cattolica 
imo	imo imho coì forse >in kaesar se` nione ro 
mature	mature maturo matura maturi immature immaturo matured maturano maturazione 
physically	fisicamente mentalmente atomicamente basicamente dinamicamente caoticamente otticamente emotivamente virtualmente 
sequences	sequenze sequenza sequenz sequenti sottosequenze sequen sequenziali sequente scene 
breast	cancro tumore mammella aids pelvic carcinoma prostata pancreas tumorectomia 
beast	bestia beast superbeast mostri creature bestie demon monster tondemon 
raja	raja rajid rani maharaja singh rajaraja bhatta ravi bhatti 
für	für und salzburgisches bergisches bergischen währung deutschen hamburgisches klinisches 
educator	educatore insegnante attivista docente pedagogista pedagogo filantropo educatrice eminente 
bang	bang big yang 英雄本色 bo dong rong tong phang 
griffin	griffin derwood zorlon hughes mccullen forlon connor hercules tiffin 
rhodes	rhodes rodi creta austini ellade salamia cawkwell hart amfipoli 
preparing	preparazione preparar preparasi preparativi preparare preparando prepararsi prepar preparsi 
proportion	proporzione percentuale monoporzione percento percentualmente proporzionalmente proporzionalità sproporzione proporzionata 
itv	itv bbc rai mediaset cbbc tv# televisivo#non televisivi televisiva 
ana	ana fernanda clara monica erena cruz talina baraca teresita 
ceiling	soffitto pavimento soffitti tetto vetrata controsoffitto pareti cassettone muro 
rainbow	arcobaleno arcobalena rainbow rainbow/ rainbow~ arcobaleni arcobaleno» moonlight captain★rainbow 
demon	demon demone demoniac tenebre demoni demonio tondemon lucifer enma 
prussian	prussi prussiano prussiana prussiani pruss prusso prussia prussico prussiane 
equations	equazioni equazione equazionale teorema geometria teoremi m,a matema coefficienti 
answered	domandato risposto domandate risponder risponderete domandati rispondendo domande risposta 
ist	sind oben nicht erlöser nnt drüben icht ist weißt 
perception	percezione percezioni appercezione sensibilità autopercezione perception sensibilità» sensazionalità sensazione 
distributor	distributore distributrice distributori distribuzione distributor distributo distributrici distributi distribuiçao 
entities	entità enti sfere organizzazioni sovranazionali locazioni interdipendenze unificatori controparti 
jackie	jackie sammy sam johnny charlie joey johnna barry eddie 
dynamics	dinamica dinamiche fluidodinamica dinamici dinamic fluidodinamiche dynamica simulazione simulazioni 
fiji	figi tonga vanuatu polinesia australia tahiti zelanda mauritius fiji 
insufficient	insufficiente sufficienti mancanza insufficienti sufficiente insufficientemente insufficient insufficienze scarsità 
algebra	algebra matematica algebrica algebris geometria aritmetica matema algebrico algebre 
homer	homer argo teseide bart homer³ homero ulisse aristeas iolao 
larvae	larve parassitati bruchi frutti neanidi planctofagi larva parassiti parassitate 
limestone	calcare calcarenite arenaria calcarea granito arenari calcaree granitic scisto 
johns	johns hopkins washington baltimora fitzwilliams hopkin gilroy dottone foster 
chaos	caos chaos disordine caotica darkworld maelstrom discordia caotico outworld 
chang	chang tiang huang wei cheng chen yuang yang ying 
layers	strati strato stratificati stratifica stratificato stratificate stratiformi stratified granule 
crater	cratere craters crater crateris crateri crate crates cratero crateria 
chad	chad ciad faso matt toby ryan centrafrica maurita tom 
seized	catturato saccheggiato confiscata confiscato sequestrato saccheggiata impadronito catturata saccheggiati 
webster	webster piercy hillier collinsworth mason gibbs merrick taylor hannaford 
depicting	raffiguranti raffigurazione ritraente raffigura raffiguri raffigurante ritraenti raffigurati raffigurato 
excess	eccesso aumento riduzione millilitro diminuzione mol/l μn eccedente elevati 
bombardment	bombardamento #bombardamento bombardament bombardando bombardano bombardava bombardare bombardi bombardandone 
hurling	hurling kilkenny cork irlando armagh irlandese fermanagh hurlingham irlandesità 
ashley	ashley olivia melissa nicole justin jessi francesca monica vanessa 
dot	dot nuvola puntino cmpclz alt+s freccia quadling sloc cerchietto 
gif	gif png logo file svg immagine jpeg image jpe 
translator	traduttore traduttor tradutore traduttoria traduttori traduttorese traduttrice traduttrici traduzione 
cowboys	cowboys raiders redskin denver ravens redskins eagles patriots niners 
counted	contato contati conteggiato conteggiata conteggiati conteggiate contata contate conteggia 
hanging	impicca hanged impiccato impicchino impiccare hanging impiccata appeso impiccarsi 
soprano	soprano mezzosoprano contralto soprani tenore baritono mezzosoprani contralti coro 
interviewed	intervistato intervistata intervistati intervistate intervistano intervisti intervistava intervistatori intervistando 
workshops	workshop workshops conferenze mostre laboratori convegni seminari presentazioni esposizioni 
terrain	innevati montagne impervio desertica impervie innevate impervi innevato piste 
belarus	bielorussia ucraina lituania polonia russia estonia lettonia bielorussi azerbaigian 
liked	piaceva piacevano preferiti apprezzato piaciuto piac piaci lodato elogiato 
console	console portatile wii pc nintendo joypad gamecube dreamcast konsole 
nascar	nascar daytona rally automobilismo motocross motorsport auto automobilista motorsports 
teenage	teenager adolescenziale adolescente teenagers adolescenti preadolescente adolescent preadolescenti teenage 
applying	applicando applicare applicato applicazione applica applicandosi applicandola applicandolo applicandoli 
vandal	vandal vandalo vandala vandalbot vandalica vandalize vandalfighter vandale vandali 
graduates	laureati studenti laureate docenti allievi neolaureati insegnanti laureandi professori 
jungle	giungla jungla jungle giungle giungla» jungler mungle foresta jungles 
placement	posizionamento collocazione posizionamenti riposizionamento posizionali inserimento apparazione malposizionamento posizione 
fairy	fiabe fiaba favola favole fata fairy cenerentola sirenetta pinocchio 
tourists	turisti visitatori turist turistica turistiche attrazioni turis turistici turiste 
reasonably	ragionevolmente sufficientemente ragionevoli ragionevole discretamente abbastanza efficamente irragionevolmente suffcientemente 
performs	esegue eseguisce eseguito eseguita eseguendo eseguirà eseguono esegua eseguità 
quarterly	trimestrale quadrimestrale mensile periodico quadrimestrali trimestrali trimestral rivista bimestrale 
shifted	spostato spostata spostati orientato riorientato riorientata spostate focalizzato riposizionato 
romans	romani etruschi romano dunum latini segeste crustumium cassio agrippa 
rpm	rpm cv/ giri giri/minuto aphon kw/t potenza turbo hp 
diploma	diploma laurea conseguito master lauree diplomandi diplomi bachelor diplom 
circa	secolo ๑☞ , xv° 寳林傳 risalente presumibilmente mappamondo secolo– 
environments	ambiente ambienti ambiente, applicazioni microambienti scenari piattaforme microambiente ambientali 
collaborative	collaborazione collaborativa collaborativo collaborative collaborativi progetto collaborativita collaborano collaborativamente 
swan	swan cigno griever cigni arrow lark dring eagleheart zard 
carpenter	carpenter carpentiere carpente tillman foore callister harrison muratore pescatore 
petition	petizione ingiunta appello 중구 petizioni ingiunto approvazione richiesta protesta 
boris	boris vladimir ivan vladimirovic ivanov vladimirov ,vladimir mikhail petrovic 
berry	berry ducher fiore lemon rose blossom frutt linard difiore 
invention	invenzione invenzio invenzioni invento invente inventore brevetta invent inventor 
southampton	southampton ipswich portsmouth liverpool manchester newcastle northampton norwich carhampton 
prairie	prateria prairie cheyenne fort leslee seminole mississipi sheyenne praire 
bend	bend falls piegan forks cedar curvare cruna piegare freccia 
app	app ipad iphone mobileme ios android interattivo smartphone spotify 
finalist	finalisti vincitore premio vincitrice finalist concorso vincitor finalista semifinalista 
questioned	contestata contestato dubitata interrogato interrogati criticato smentito criticata vistato 
explicit	esplicito esplicita espliciti esplicite esplicitazione esplicitazioni esplicità esplicitando esplicitarsi 
draws	sfide vincita affronta draw tiene realizza contemporaneo trae incontri 
governed	governata governato amministrato amministrata governati governa governate gestite amministrate 
slight	lieve lievi lievissima lievissimo liever lievin lievissimi marcato brusco 
drag	drag speed spinta tap driver lizer tramping scooler backsquat 
maxwell	maxwell maxwel selfridge newton ,dall gordon newtone malcom archibaldi 
planes	aerei aereo aeroplani velivoli aereoplani bombardieri quadrimotori aeronavi aeroplano 
oriental	oriental orientali oriente orientale, asiatica orientalia orientale» orientale shanghai 
manufacture	fabbricazione fabbricar fabbricazioni fabbricare fabbricante produzione fabbricano fabbricarne fabbricanti 
acclaimed	acclamato acclamata acclamati pluripremiato acclamator acclamate apprezzato lodato apprezzati 
coordinator	coordinatore vicecoordinatore coordino coordinato coordini coordinamento assistente coordinator coordina 
bombs	bombe bomba ordigni bomb autobombe bombard detona sganci incendiari 
mohammad	mohammad ahmad mohammadkhani ahmal mukhammad khad khata khat mohamad 
bassist	batterista bassista chitarrista bassista/chitarrista chitarrista/bassista chitarrista/cantante batterista/cantante chitarrista/tastierista bassista/cantante 
superman	superman superman» superman/batman superboy batman supergirl jla/avengers krypton supereroe 
colombian	colombiana colombiano colombiani colombian colombianas venezuelani guatemalteca peruviani venezuelane 
philippe	philippe ludovic françois lefrançois nançois jean pierre filippe sébastienne 
felix	felix victor max marco hugo vallentin sebastian alfredo fabian 
bengali	bengalese punjabi hindi bengalesi bengali urdu malayalam indiano pakistana 
greene	greene mcpherson harrison breene custer schofield carter adams sullivan 
voluntary	volontaria volontariato volontarie volontario volontari assistenza volontaria» volonta volontarietà 
floating	floating floatin galleggiante float galleggia floaters galleggiare galleggi galleggianti 
montenegro	montenegro serbia croazia bosnia bulgaria montenegrone erzegovina slovenia montenegrina 
sketch	schizzo sketch sketchy ritratto docudramma cartone schizzi scenetta bozzetto 
mann	mann brechner stein seider pirker mayer brecher brenn mannhardt 
flooding	inondazione inondazioni inondo allagamento esondazione alluvioni inonda inondi alluvione 
escort	scorta scortata escort scortare flottiglia pattugliamento scortarla pattugliata cacciatorpediniere 
dressed	vestito vestita indosso vestite svestito indossante abbigliata indossato indossati 
astronomy	astronomia astronomix astronomia» astronom astronomia/astrologia astronomiam ·astronomia astronomicon radioastronomia 
sudden	improvviso improvvisa repentino repentina repentini repentine improvvise brusco improvvisi 
variables	variabili parametri parametrici parametrico variabile parametr aleatori parametriche invariabili 
arbitrary	arbitrario arbitraria arbitrari arbitrarie arbitrariamente arbitrarietà arbitrariato arbitraria» 하는 
skiing	sci snowboard sciare snowboarding equitazione alpinismo kayak freeride alpino 
timothy	daniele matteo timothy cristopher matthew giacomo christopher pierfilippo james 
cello	violoncello violino flauto pianoforte violoncellos violoncelli violini violoncelle violino, 
rainfall	piogge pioggi precipitazioni pioggia piovosità piovose piovoso siccità piovosi 
rafael	rafael rafaelo josé rafael, josè parejos rafaele trejos joaquím 
sphere	sfera sfere cerchio sferico sfer sphere intersfera sferic globo 
rewrite	riscrivere riscrive riscrittura riscrivi riscriva riscriverne riscriversi riscritto riscriverò 
georg	georg friedrich wilhelm carlfriedrich karl wilhelmer friederich wilhelmj ludwig 
cinematography	fotografia montaggio scenografia sonoro fotografiamiglior sceneggiatura montatore visivi film 
canvas	tela dipinto olio pannello autoritratto tempera quadretto tela, dipintore 
chest	petto schiena torace collo braccio gamba orecchino orecchio palmo 
krishna	krishna bhati bhai bhat dhana lakshya bhashya bhi bhar 
provider	provider fornitore fornitori telefonia network» netcom telecomunicazione servizi internetwork 
frances	margaret isabella frances mary elizabetta elisabella isabel elizabeth francesca 
crowned	incoronati incoronate incorona incoronato incoronata coronato incoronano incoronatella corona 
wanting	desiderami desiderio voler desiderando volendo desiderosa intenzione desideroso esorti 
carved	scolpito scolpite scolpiti scolpita intagliato intagliati bassorilievo intagliata monoliti 
poles	polacchi bastoni poloni campi pińsk ucraini pods podî d} 
cabin	cabina capanna alloggia vagone passeggero stiva alloggio conestoga motel 
civilization	civiltà civilta #civiltà civilizzazione civilizzato civiltà» preistoria inciviltà civilizado 
avoided	evitato evitati evitata evitare evitate evitarsi evitanto evitante evitanti 
lisbon	lisbona oporto portogallo coimbra cascais portogalli belém madrid janeiro 
eliminate	eliminare elimini eliminarne eliminazione elimina rimuovere prevenire ridurre evitare 
panels	pannelli pannello pannel panel pannellature vetrati pannellatura panner lastre 
darwin	darwin darwine darwins darwin_ #darwin darwi darwinneon darwini darwinia 
cheese	formaggio formaggia formaggi#formaggi formaggino formaggi formaggio» cioccola pane salame 
easter	pasqua capodanno festa festività natale pentecoste easter candelora celebrazione 
rat	topo coniglio rat ratto topi ratty scimmia komodo ratte 
papua	papua guinea figi indonesia vanuatu papuasia polinesia zelanda australia 
insert	inserisci inserire intestazione insert foglio riquadro inserto stringa inseriscilo 
descriptions	descrizioni descrizione dettaglia dettagliati dettagliato dettagliata dettagliate descrittive dettagliano 
debates	dibattiti dibattito dibatti dibattitto discussioni questioni dibattimenti dibattici dibatto 
informal	informale informali formalms informalmente colloquia formale informal riunioni ristretti 
castles	castelli castello fortezze fortezza castle palazzi fortificazioni castello/fortezza torri 
cry	cry grido gridai gridare gridalo urlo forsake forsaken zbkt 
loyal	leale fedele leali fidati fedeli grati ribelle lealtà fidate 
surfaces	superfici superfice isosuperfici superficie superficie/superficie superficie, intersuperfici ipersuperfici reticoli 
nicolas	nicolas françois benoît michel sébastian nicolaï fernardo nicolasa ludovic 
institutes	istituti instituti accademie sedi istituto università laboratori scuole istituzioni 
humor	umorismo humor umorismo» umoristico humour umoristica humorist satira comicità 
madonna	madonna madonnaro beyoncè beyonce madonna» alesso madonnas beyoncé britney 
worcester	worcester durham binchester winchester dunchester worcesteri guildford worcestershire otford 
cooperative	cooperativa cooperativo coopera cooperativi cooperative cooperante cooperate cooperativas cooperato 
substantially	significativamente sensibilmente considerevolmente notevolmente leggermente parzialmente modificata pesantemente sostanzialmente 
winston	winston winstone churchill lincoln churchills #winston buckingham winstoni carolina 
introducing	introducendo introdurre introduzione introdusse introdotto introdotta introducendola introducendosi introducente 
llc	inc srl llc spa venture acquisizione telcom sca scpa 
drake	drake sebastian cortez branston southerly bater payne lambert hood 
lunar	lunare luna lunar lunari lunah allunaggio astronauti lunares marte 
fountain	fontana fountain fontane giardino cenotafio obelisco alcova stello fountaine 
consulting	consulenza consulenze consulenti consulente partners consulting partnership management immobiliare 
patricia	marcella linda renata patricia roberta laura lilia evelina rosanna 
ers	ers raiders dolphins chargers broncos eagles spurs packers vikings 
garcía	garcía arías herrero arón carías jiménez garcìa aguillón aguilón 
rid	eliminare elimini rimuovere togliere ##i rimuovete rimuove controllare sbarazzare 
maple	maple acero leaf albero tigli abete quercia noccioli kaple 
aberdeen	aberdeen edimburgo glasgow edimburgh scozia edimburg inverness dundee scozzese 
verb	verbo desinenza participio accusativo desinenze verbi coniugazione desinente sostantivo 
illustrations	illustrazioni illustrati illustrate illustrazione illustrata disegni illustrante illustrato illustratori 
mechanisms	meccanismi meccanismo processi servomeccanismi sistemi funzionamenti tipi funzionamento fattori 
posters	manifesti locandine poster cartelloni volantini cartoline locandina fotografie foto 
underwent	sottoposto subì subìto sottopostosi rimodernamento sottoposta completato sottopose ristrutturazione 
leipzig	berlino lipsia dresda bonn amburgo würzburg halle francoforte berlino, 
santo	domingo fonso são rico castelões triunfo santo ciúme cruz 
engaging	coinvolgente impegnando azione coinvolgenti mirato coinvolti impegnarsi coinvolgendoli mirati 
roland	roland rolanda rolande fernard ivo raymondo raymond sigfred fernando 
expelled	espulso espulsi espulsa espulse espulsore espulsero liberato espulsione allontanati 
evident	evidenti evidente evides evident evidenziata evidenza accentuati marcata influenzata 
staged	organizzato organizzata inscenato teatro allestito inteatro organizzati inscenata svoltosi 
telecommunications	telecomunicazioni telecomunicazione communicazione comunicazioni telecomunicazionistico radiocomunicazione #comunicazione assocomunicazione comunicazionale 
strait	strait stretto isole terraferma isola arcipelago baia bering barents 
unanimous	unanime unani unanimi unanimente unanimità decisione unanimita decisio verdetto 
misleading	fuorviante fuorvianti errata fuorviato inesatto inesatta forviante ingannevole errato 
sherman	sherman asherman patton shermann shermy lincoln shermer sherm forrest 
stefan	stefan ,stefan florian klaus andreas ştefan bogdan delgrado niklas 
sleeping	dormin dormire addormento sonno addormenti addormentata addormentate dorme addormentarla 
alto	clarin clarindo clarino clarina clarinda cajon sol la¹ basso 
crucial	cruciale importante fondamentale decisivo importantissimo cruciali essenziale determinante decisive 
thomson	thomson maxwell watson richardson coutts hughson challis thomsoni macrobertson 
directing	dirigendo dirigere diretto registica film sceneggiatura dirigerli casting direzione 
prehistoric	preistorico preistorici preistoriche preistoria preistorie preistorica paleolitico neolitico preist 
communicate	comunicare communicare comunicano dialogare comunicarli comunicalo comunicarsi comunicarti chattare 
alphabet	alfabeto alfabet ecoalfabeto alfabeti alfabeto» alfabeta alfabetiere lingua glagol 
zagreb	zagabria belgrado lubiana osijek spalato zagreb belgrad croazia vrnjacka 
chef	chef cuoco ristorante gourmet cuoche pasticcere pasticciere cuochi ristoratore 
tubes	tubi tubo tubet parasiluri cilindriche tubetti antisiluri cilindrici tuboli 
carnegie	carnegie carnegiea mellon carnegia rockefeller carnegiella guggenheim guildhall yale 
hostile	ostile ostili diffidenti diffidente aggressiva agguerrito bellicosa minacciosi feroci 
prizes	premi premio premiazioni vincita concorsi riconoscimenti vincite premiati prize 
eighteen	diciotto sedici seven twenty dieci quindici venticinque diciassette trentasette 
shirt	maglietto maglietta shirt maglietti vestito magliette indossai indosso indossare 
weird	fantaso strana strano bizzarro strani weird fantasticks bizzarra strane 
namespace	namespace namespaces wediawiki awiki mediawiki #mediawiki default wikispam sottopagine 
pursued	intrapreso intrapresa conseguito proseguito studiato inseguito perseguito conseguita guidato 
loading	caricamento stivaggio caricatore carico scaricamento precaricamento #caricamento ricaricamento movimentazione 
edges	bordi margini 하는 spigoli superfici diagonali orlati facce quadratini 
plantation	piantagione piantagioni fattoria colono rale plantation boschetto hacienda ranch 
vernon	raleigh enry henry hampton teston oakford vernon fanton goldington 
acre	acri ettari acro m² appezzamento acres terra, terrenove area 
practiced	praticata praticato praticati praticate praticare praticava praticar praticavano praticante 
wonderful	meravigliosa meraviglioso meravigliosi stupenda meravigliose meravigliosa» meraviglio meravigliao stupendo 
missiles	missili missile missilistici #missili razzi lanciamissili missileer missilistico guidamissili 
guides	guide guida guider guides scout guidesi escursioni videoguide mapguide 
finger	dito dita pollice tasta palmo finger pad tocco hand 
garage	garage rockgarage motel clubhouse magazzino parcheggia parcheggio camper parcheggiata 
savage	savage selvaggi savagery kane selvaggio selvaggia eden norstar foley 
technological	tecnologico tecnologica tecnologie tecnologiche tecnologici tecnologia tecnologi /tecnologia tecnopoli 
rises	innalza eleva alza innalzano scende elevano innalzo scender vise 
shoes	scarpe jeans calzature calze indumenti pantaloni giacchette abiti scarpette 
climbing	arrampicata arrampicate arrampicato arrampicati arrampicare arrampica arrampicatosi scalata arrampicata#scale 
barrel	canna barile bossolo fucile cannone camerato cannoncino culatta pistola 
biographies	biografie biografi biografe biografia biografiche biografii biografien biografija biografiju 
spite	nonostante malgrado dispetto nonostanti causa ciononostante nonostanze #nonostante ,nonostante 
assembled	assemblato assemblati assemblate assemblata assembla preassemblati preassemblata riassemblati riassemblato 
ham	ham toffee pane pastine pastin pasting ghee broccoli garpastum 
geoffrey	geoffrey riccardo geoffredo jeoffrey #geoffrey basil fitzgeoffrey sir ralph 
valve	valvola valvole servovalvola valvolare valvolame valve valvolari idrovalvola elettrovalvola 
commenting	commentando commenti commentato lodando commento commentino elogiando commentare giudizio 
osaka	osaka tokyo ōsaka kyoto fukuoka nishitokyo nagoya itami ōsaki 
beck	beck brendler martin bleckinger wendler wasserstein hagenberg blecker graßl 
analog	analogico analogici analogica analogiche analogico/digitali analogico/digitale digitale segnale dualogic 
monkey	scimmia panda tigre elefante gatto monkey coniglio scimmione gorilla 
tackle	offensive halfback cornerback linebacker punter palla lineback fullback cornerbacks 
listening	ascoltando ascoltanto ascoltare ascolto ascoltar ascoltante ascoltalo ascoltarsi ascoltandolo 
integrity	integrità integrity solidità stabilità sicurezza coesione sicurezza, preservazione integritas 
sits	siede seduto giace sied sieda trova staglia adagiato affacciato 
definitions	definizioni termini definizione #definizione concetti ridefinizioni definiz definizio terminologici 
baldwin	baldwin archibaldo ottone baldovin lascala isabella raimondo gordone gernon 
troop	aerotrasportato fanteria squadrone aviotrasportato aerotrasportata troop aerotrasporto aviotrasportata aviotrasporto 
objections	obiezioni obbiezioni critiche perplessità obiezione opposizioni richieste proposte obbiezione 
marina	marina ria alina marinca cristina, sirota miramare resort beach 
detection	rilevazione rilevamento detezione individuazione detection calibrazione #individuazione rilevaza monitoraggio 
sixty	centoquarantadue centoquarantanove centoquarantacinque cento duecentoquaranta quarantaduemila duecentoquattro centoquarantasette trecentosessantacinque 
differential	differenziale equazionale differenziali equazione geometria equazioni teorema v,a parametrico 
linguistic	linguistici linguistica linguistico etnolinguistico etnolinguistica linguistico» linguistiche sociolinguistico metalinguistico 
venus	venere venus marte luna giove saturno venuse mercurio apollo 
salmon	salmone salmoni salmon salmond pesce salmonide salmons merluzzi pesca 
monarchy	monarchia monarchies monarca restaurazione monarchico monarchie monarchi reinstaurazione monarchica 
adminship	autocandidatura autocandidature candidatura fiducia adminship admin vajotwo utento desysop 
stade	stade stades stadio gues viers cuise scq stader népstadion 
depicts	raffigura ritrae raffigurato ritraente raffigurava raffigurazione raffigurata raffiguri raffigurante 
francesco	francesco 미 ,giovanni giovanfrancesco ,francesco giovanni baldassari domenico canfrancesco 
abortion	aborto eutanasia abortista abortiste eutanasia» aborti abortisca legalizzazione antiabortista 
monica	monica clara serena paula ana lucia rita cecilia barbara 
